county_name,candidate_id,election_day,absentee_by_mail,advance_in_person,provisional,total_votes,result_id
Appling,86c4b8db0e614c12343f89ce974b91902e787f1fbd798005af0f140b51d7b929,2948,362,2182,2,5494,Appling86c4b8db0e614c12343f89ce974b91902e787f1fbd798005af0f140b51d7b929
Atkinson,86c4b8db0e614c12343f89ce974b91902e787f1fbd798005af0f140b51d7b929,843,58,972,5,1878,Atkinson86c4b8db0e614c12343f89ce974b91902e787f1fbd798005af0f140b51d7b929
Bacon,86c4b8db0e614c12343f89ce974b91902e787f1fbd798005af0f140b51d7b929,1142,134,2082,6,3364,Bacon86c4b8db0e614c12343f89ce974b91902e787f1fbd798005af0f140b51d7b929
Baker,86c4b8db0e614c12343f89ce974b91902e787f1fbd798005af0f140b51d7b929,396,76,302,1,775,Baker86c4b8db0e614c12343f89ce974b91902e787f1fbd798005af0f140b51d7b929
Baldwin,86c4b8db0e614c12343f89ce974b91902e787f1fbd798005af0f140b51d7b929,2929,330,4433,5,7697,Baldwin86c4b8db0e614c12343f89ce974b91902e787f1fbd798005af0f140b51d7b929
Banks,86c4b8db0e614c12343f89ce974b91902e787f1fbd798005af0f140b51d7b929,3079,195,2858,2,6134,Banks86c4b8db0e614c12343f89ce974b91902e787f1fbd798005af0f140b51d7b929
Barrow,86c4b8db0e614c12343f89ce974b91902e787f1fbd798005af0f140b51d7b929,8881,755,11471,1,21108,Barrow86c4b8db0e614c12343f89ce974b91902e787f1fbd798005af0f140b51d7b929
Bartow,86c4b8db0e614c12343f89ce974b91902e787f1fbd798005af0f140b51d7b929,15525,1038,13327,21,29911,Bartow86c4b8db0e614c12343f89ce974b91902e787f1fbd798005af0f140b51d7b929
Ben Hill,86c4b8db0e614c12343f89ce974b91902e787f1fbd798005af0f140b51d7b929,907,115,2712,5,3739,Ben Hill86c4b8db0e614c12343f89ce974b91902e787f1fbd798005af0f140b51d7b929
Berrien,86c4b8db0e614c12343f89ce974b91902e787f1fbd798005af0f140b51d7b929,2351,267,2790,14,5422,Berrien86c4b8db0e614c12343f89ce974b91902e787f1fbd798005af0f140b51d7b929
Bibb,86c4b8db0e614c12343f89ce974b91902e787f1fbd798005af0f140b51d7b929,12591,1413,9998,41,24043,Bibb86c4b8db0e614c12343f89ce974b91902e787f1fbd798005af0f140b51d7b929
Bleckley,86c4b8db0e614c12343f89ce974b91902e787f1fbd798005af0f140b51d7b929,1505,136,2076,2,3719,Bleckley86c4b8db0e614c12343f89ce974b91902e787f1fbd798005af0f140b51d7b929
Brantley,86c4b8db0e614c12343f89ce974b91902e787f1fbd798005af0f140b51d7b929,2510,200,2851,6,5567,Brantley86c4b8db0e614c12343f89ce974b91902e787f1fbd798005af0f140b51d7b929
Brooks,86c4b8db0e614c12343f89ce974b91902e787f1fbd798005af0f140b51d7b929,1769,156,1754,22,3701,Brooks86c4b8db0e614c12343f89ce974b91902e787f1fbd798005af0f140b51d7b929
Bryan,86c4b8db0e614c12343f89ce974b91902e787f1fbd798005af0f140b51d7b929,3899,286,6336,8,10529,Bryan86c4b8db0e614c12343f89ce974b91902e787f1fbd798005af0f140b51d7b929
Bulloch,86c4b8db0e614c12343f89ce974b91902e787f1fbd798005af0f140b51d7b929,7334,591,7142,30,15097,Bulloch86c4b8db0e614c12343f89ce974b91902e787f1fbd798005af0f140b51d7b929
Burke,86c4b8db0e614c12343f89ce974b91902e787f1fbd798005af0f140b51d7b929,2254,256,1981,0,4491,Burke86c4b8db0e614c12343f89ce974b91902e787f1fbd798005af0f140b51d7b929
Butts,86c4b8db0e614c12343f89ce974b91902e787f1fbd798005af0f140b51d7b929,1769,186,4762,0,6717,Butts86c4b8db0e614c12343f89ce974b91902e787f1fbd798005af0f140b51d7b929
Calhoun,86c4b8db0e614c12343f89ce974b91902e787f1fbd798005af0f140b51d7b929,445,44,340,1,830,Calhoun86c4b8db0e614c12343f89ce974b91902e787f1fbd798005af0f140b51d7b929
Camden,86c4b8db0e614c12343f89ce974b91902e787f1fbd798005af0f140b51d7b929,4876,608,6813,13,12310,Camden86c4b8db0e614c12343f89ce974b91902e787f1fbd798005af0f140b51d7b929
Candler,86c4b8db0e614c12343f89ce974b91902e787f1fbd798005af0f140b51d7b929,567,86,2008,3,2664,Candler86c4b8db0e614c12343f89ce974b91902e787f1fbd798005af0f140b51d7b929
Carroll,86c4b8db0e614c12343f89ce974b91902e787f1fbd798005af0f140b51d7b929,13018,901,16070,40,30029,Carroll86c4b8db0e614c12343f89ce974b91902e787f1fbd798005af0f140b51d7b929
Catoosa,86c4b8db0e614c12343f89ce974b91902e787f1fbd798005af0f140b51d7b929,6827,460,13573,16,20876,Catoosa86c4b8db0e614c12343f89ce974b91902e787f1fbd798005af0f140b51d7b929
Charlton,86c4b8db0e614c12343f89ce974b91902e787f1fbd798005af0f140b51d7b929,1220,158,1567,6,2951,Charlton86c4b8db0e614c12343f89ce974b91902e787f1fbd798005af0f140b51d7b929
Chatham,86c4b8db0e614c12343f89ce974b91902e787f1fbd798005af0f140b51d7b929,30267,1915,13462,44,45688,Chatham86c4b8db0e614c12343f89ce974b91902e787f1fbd798005af0f140b51d7b929
Chattahoochee,86c4b8db0e614c12343f89ce974b91902e787f1fbd798005af0f140b51d7b929,420,34,292,5,751,Chattahoochee86c4b8db0e614c12343f89ce974b91902e787f1fbd798005af0f140b51d7b929
Chattooga,86c4b8db0e614c12343f89ce974b91902e787f1fbd798005af0f140b51d7b929,3034,144,3279,5,6462,Chattooga86c4b8db0e614c12343f89ce974b91902e787f1fbd798005af0f140b51d7b929
Cherokee,86c4b8db0e614c12343f89ce974b91902e787f1fbd798005af0f140b51d7b929,31540,3546,45545,18,80649,Cherokee86c4b8db0e614c12343f89ce974b91902e787f1fbd798005af0f140b51d7b929
Clarke,86c4b8db0e614c12343f89ce974b91902e787f1fbd798005af0f140b51d7b929,5678,939,6079,21,12717,Clarke86c4b8db0e614c12343f89ce974b91902e787f1fbd798005af0f140b51d7b929
Clay,86c4b8db0e614c12343f89ce974b91902e787f1fbd798005af0f140b51d7b929,162,36,366,2,566,Clay86c4b8db0e614c12343f89ce974b91902e787f1fbd798005af0f140b51d7b929
Clayton,86c4b8db0e614c12343f89ce974b91902e787f1fbd798005af0f140b51d7b929,4119,889,7621,16,12645,Clayton86c4b8db0e614c12343f89ce974b91902e787f1fbd798005af0f140b51d7b929
Clinch,86c4b8db0e614c12343f89ce974b91902e787f1fbd798005af0f140b51d7b929,680,56,988,3,1727,Clinch86c4b8db0e614c12343f89ce974b91902e787f1fbd798005af0f140b51d7b929
Cobb,86c4b8db0e614c12343f89ce974b91902e787f1fbd798005af0f140b51d7b929,79118,12461,61089,244,152912,Cobb86c4b8db0e614c12343f89ce974b91902e787f1fbd798005af0f140b51d7b929
Coffee,86c4b8db0e614c12343f89ce974b91902e787f1fbd798005af0f140b51d7b929,3051,295,6242,0,9588,Coffee86c4b8db0e614c12343f89ce974b91902e787f1fbd798005af0f140b51d7b929
Colquitt,86c4b8db0e614c12343f89ce974b91902e787f1fbd798005af0f140b51d7b929,4968,260,4667,3,9898,Colquitt86c4b8db0e614c12343f89ce974b91902e787f1fbd798005af0f140b51d7b929
Columbia,86c4b8db0e614c12343f89ce974b91902e787f1fbd798005af0f140b51d7b929,17194,1802,24070,19,43085,Columbia86c4b8db0e614c12343f89ce974b91902e787f1fbd798005af0f140b51d7b929
Cook,86c4b8db0e614c12343f89ce974b91902e787f1fbd798005af0f140b51d7b929,1594,149,2433,0,4176,Cook86c4b8db0e614c12343f89ce974b91902e787f1fbd798005af0f140b51d7b929
Coweta,86c4b8db0e614c12343f89ce974b91902e787f1fbd798005af0f140b51d7b929,18778,1892,21851,12,42533,Coweta86c4b8db0e614c12343f89ce974b91902e787f1fbd798005af0f140b51d7b929
Crawford,86c4b8db0e614c12343f89ce974b91902e787f1fbd798005af0f140b51d7b929,1615,153,1864,3,3635,Crawford86c4b8db0e614c12343f89ce974b91902e787f1fbd798005af0f140b51d7b929
Crisp,86c4b8db0e614c12343f89ce974b91902e787f1fbd798005af0f140b51d7b929,1354,205,2981,9,4549,Crisp86c4b8db0e614c12343f89ce974b91902e787f1fbd798005af0f140b51d7b929
Dade,86c4b8db0e614c12343f89ce974b91902e787f1fbd798005af0f140b51d7b929,2547,115,2385,4,5051,Dade86c4b8db0e614c12343f89ce974b91902e787f1fbd798005af0f140b51d7b929
Dawson,86c4b8db0e614c12343f89ce974b91902e787f1fbd798005af0f140b51d7b929,2423,422,7039,16,9900,Dawson86c4b8db0e614c12343f89ce974b91902e787f1fbd798005af0f140b51d7b929
Decatur,86c4b8db0e614c12343f89ce974b91902e787f1fbd798005af0f140b51d7b929,2242,284,3483,11,6020,Decatur86c4b8db0e614c12343f89ce974b91902e787f1fbd798005af0f140b51d7b929
DeKalb,86c4b8db0e614c12343f89ce974b91902e787f1fbd798005af0f140b51d7b929,22867,3886,24669,46,51468,DeKalb86c4b8db0e614c12343f89ce974b91902e787f1fbd798005af0f140b51d7b929
Dodge,86c4b8db0e614c12343f89ce974b91902e787f1fbd798005af0f140b51d7b929,2732,235,2054,0,5021,Dodge86c4b8db0e614c12343f89ce974b91902e787f1fbd798005af0f140b51d7b929
Dooly,86c4b8db0e614c12343f89ce974b91902e787f1fbd798005af0f140b51d7b929,815,68,1059,9,1951,Dooly86c4b8db0e614c12343f89ce974b91902e787f1fbd798005af0f140b51d7b929
Dougherty,86c4b8db0e614c12343f89ce974b91902e787f1fbd798005af0f140b51d7b929,5917,514,3796,5,10232,Dougherty86c4b8db0e614c12343f89ce974b91902e787f1fbd798005af0f140b51d7b929
Douglas,86c4b8db0e614c12343f89ce974b91902e787f1fbd798005af0f140b51d7b929,7655,1198,15952,12,24817,Douglas86c4b8db0e614c12343f89ce974b91902e787f1fbd798005af0f140b51d7b929
Early,86c4b8db0e614c12343f89ce974b91902e787f1fbd798005af0f140b51d7b929,1093,140,1319,0,2552,Early86c4b8db0e614c12343f89ce974b91902e787f1fbd798005af0f140b51d7b929
Echols,86c4b8db0e614c12343f89ce974b91902e787f1fbd798005af0f140b51d7b929,395,38,574,0,1007,Echols86c4b8db0e614c12343f89ce974b91902e787f1fbd798005af0f140b51d7b929
Effingham,86c4b8db0e614c12343f89ce974b91902e787f1fbd798005af0f140b51d7b929,8084,432,9351,7,17874,Effingham86c4b8db0e614c12343f89ce974b91902e787f1fbd798005af0f140b51d7b929
Elbert,86c4b8db0e614c12343f89ce974b91902e787f1fbd798005af0f140b51d7b929,1979,272,3018,23,5292,Elbert86c4b8db0e614c12343f89ce974b91902e787f1fbd798005af0f140b51d7b929
Emanuel,86c4b8db0e614c12343f89ce974b91902e787f1fbd798005af0f140b51d7b929,2776,217,2337,5,5335,Emanuel86c4b8db0e614c12343f89ce974b91902e787f1fbd798005af0f140b51d7b929
Evans,86c4b8db0e614c12343f89ce974b91902e787f1fbd798005af0f140b51d7b929,675,122,1607,0,2404,Evans86c4b8db0e614c12343f89ce974b91902e787f1fbd798005af0f140b51d7b929
Fannin,86c4b8db0e614c12343f89ce974b91902e787f1fbd798005af0f140b51d7b929,4326,621,4676,9,9632,Fannin86c4b8db0e614c12343f89ce974b91902e787f1fbd798005af0f140b51d7b929
Fayette,86c4b8db0e614c12343f89ce974b91902e787f1fbd798005af0f140b51d7b929,10790,1625,22626,7,35048,Fayette86c4b8db0e614c12343f89ce974b91902e787f1fbd798005af0f140b51d7b929
Floyd,86c4b8db0e614c12343f89ce974b91902e787f1fbd798005af0f140b51d7b929,9959,778,13308,69,24114,Floyd86c4b8db0e614c12343f89ce974b91902e787f1fbd798005af0f140b51d7b929
Forsyth,86c4b8db0e614c12343f89ce974b91902e787f1fbd798005af0f140b51d7b929,17334,2579,49914,24,69851,Forsyth86c4b8db0e614c12343f89ce974b91902e787f1fbd798005af0f140b51d7b929
Franklin,86c4b8db0e614c12343f89ce974b91902e787f1fbd798005af0f140b51d7b929,3332,316,3406,0,7054,Franklin86c4b8db0e614c12343f89ce974b91902e787f1fbd798005af0f140b51d7b929
Fulton,86c4b8db0e614c12343f89ce974b91902e787f1fbd798005af0f140b51d7b929,40253,7198,70143,189,117783,Fulton86c4b8db0e614c12343f89ce974b91902e787f1fbd798005af0f140b51d7b929
Gilmer,86c4b8db0e614c12343f89ce974b91902e787f1fbd798005af0f140b51d7b929,4440,515,5511,11,10477,Gilmer86c4b8db0e614c12343f89ce974b91902e787f1fbd798005af0f140b51d7b929
Glascock,86c4b8db0e614c12343f89ce974b91902e787f1fbd798005af0f140b51d7b929,532,59,644,0,1235,Glascock86c4b8db0e614c12343f89ce974b91902e787f1fbd798005af0f140b51d7b929
Glynn,86c4b8db0e614c12343f89ce974b91902e787f1fbd798005af0f140b51d7b929,8969,811,11702,30,21512,Glynn86c4b8db0e614c12343f89ce974b91902e787f1fbd798005af0f140b51d7b929
Gordon,86c4b8db0e614c12343f89ce974b91902e787f1fbd798005af0f140b51d7b929,7142,424,7608,17,15191,Gordon86c4b8db0e614c12343f89ce974b91902e787f1fbd798005af0f140b51d7b929
Grady,86c4b8db0e614c12343f89ce974b91902e787f1fbd798005af0f140b51d7b929,2588,180,3279,6,6053,Grady86c4b8db0e614c12343f89ce974b91902e787f1fbd798005af0f140b51d7b929
Greene,86c4b8db0e614c12343f89ce974b91902e787f1fbd798005af0f140b51d7b929,1435,260,3793,2,5490,Greene86c4b8db0e614c12343f89ce974b91902e787f1fbd798005af0f140b51d7b929
Gwinnett,86c4b8db0e614c12343f89ce974b91902e787f1fbd798005af0f140b51d7b929,71967,10197,64325,500,146989,Gwinnett86c4b8db0e614c12343f89ce974b91902e787f1fbd798005af0f140b51d7b929
Habersham,86c4b8db0e614c12343f89ce974b91902e787f1fbd798005af0f140b51d7b929,2545,744,9898,3,13190,Habersham86c4b8db0e614c12343f89ce974b91902e787f1fbd798005af0f140b51d7b929
Hall,86c4b8db0e614c12343f89ce974b91902e787f1fbd798005af0f140b51d7b929,23488,2422,25781,42,51733,Hall86c4b8db0e614c12343f89ce974b91902e787f1fbd798005af0f140b51d7b929
Hancock,86c4b8db0e614c12343f89ce974b91902e787f1fbd798005af0f140b51d7b929,390,43,408,2,843,Hancock86c4b8db0e614c12343f89ce974b91902e787f1fbd798005af0f140b51d7b929
Haralson,86c4b8db0e614c12343f89ce974b91902e787f1fbd798005af0f140b51d7b929,4743,331,4505,6,9585,Haralson86c4b8db0e614c12343f89ce974b91902e787f1fbd798005af0f140b51d7b929
Harris,86c4b8db0e614c12343f89ce974b91902e787f1fbd798005af0f140b51d7b929,5029,457,6449,1,11936,Harris86c4b8db0e614c12343f89ce974b91902e787f1fbd798005af0f140b51d7b929
Hart,86c4b8db0e614c12343f89ce974b91902e787f1fbd798005af0f140b51d7b929,3047,297,3941,1,7286,Hart86c4b8db0e614c12343f89ce974b91902e787f1fbd798005af0f140b51d7b929
Heard,86c4b8db0e614c12343f89ce974b91902e787f1fbd798005af0f140b51d7b929,1818,196,1355,1,3370,Heard86c4b8db0e614c12343f89ce974b91902e787f1fbd798005af0f140b51d7b929
Henry,86c4b8db0e614c12343f89ce974b91902e787f1fbd798005af0f140b51d7b929,11669,1771,32218,66,45724,Henry86c4b8db0e614c12343f89ce974b91902e787f1fbd798005af0f140b51d7b929
Houston,86c4b8db0e614c12343f89ce974b91902e787f1fbd798005af0f140b51d7b929,10481,1478,23416,55,35430,Houston86c4b8db0e614c12343f89ce974b91902e787f1fbd798005af0f140b51d7b929
Irwin,86c4b8db0e614c12343f89ce974b91902e787f1fbd798005af0f140b51d7b929,1290,76,1345,5,2716,Irwin86c4b8db0e614c12343f89ce974b91902e787f1fbd798005af0f140b51d7b929
Jackson,86c4b8db0e614c12343f89ce974b91902e787f1fbd798005af0f140b51d7b929,7758,620,13376,30,21784,Jackson86c4b8db0e614c12343f89ce974b91902e787f1fbd798005af0f140b51d7b929
Jasper,86c4b8db0e614c12343f89ce974b91902e787f1fbd798005af0f140b51d7b929,1678,210,2465,7,4360,Jasper86c4b8db0e614c12343f89ce974b91902e787f1fbd798005af0f140b51d7b929
Jeff Davis,86c4b8db0e614c12343f89ce974b91902e787f1fbd798005af0f140b51d7b929,1804,165,2133,2,4104,Jeff Davis86c4b8db0e614c12343f89ce974b91902e787f1fbd798005af0f140b51d7b929
Jefferson,86c4b8db0e614c12343f89ce974b91902e787f1fbd798005af0f140b51d7b929,1482,155,1422,4,3063,Jefferson86c4b8db0e614c12343f89ce974b91902e787f1fbd798005af0f140b51d7b929
Jenkins,86c4b8db0e614c12343f89ce974b91902e787f1fbd798005af0f140b51d7b929,728,95,1069,3,1895,Jenkins86c4b8db0e614c12343f89ce974b91902e787f1fbd798005af0f140b51d7b929
Johnson,86c4b8db0e614c12343f89ce974b91902e787f1fbd798005af0f140b51d7b929,969,141,1409,0,2519,Johnson86c4b8db0e614c12343f89ce974b91902e787f1fbd798005af0f140b51d7b929
Jones,86c4b8db0e614c12343f89ce974b91902e787f1fbd798005af0f140b51d7b929,3063,391,4850,1,8305,Jones86c4b8db0e614c12343f89ce974b91902e787f1fbd798005af0f140b51d7b929
Lamar,86c4b8db0e614c12343f89ce974b91902e787f1fbd798005af0f140b51d7b929,2013,214,2956,7,5190,Lamar86c4b8db0e614c12343f89ce974b91902e787f1fbd798005af0f140b51d7b929
Lanier,86c4b8db0e614c12343f89ce974b91902e787f1fbd798005af0f140b51d7b929,785,45,1154,0,1984,Lanier86c4b8db0e614c12343f89ce974b91902e787f1fbd798005af0f140b51d7b929
Laurens,86c4b8db0e614c12343f89ce974b91902e787f1fbd798005af0f140b51d7b929,6409,641,5359,2,12411,Laurens86c4b8db0e614c12343f89ce974b91902e787f1fbd798005af0f140b51d7b929
Lee,86c4b8db0e614c12343f89ce974b91902e787f1fbd798005af0f140b51d7b929,4925,311,5408,2,10646,Lee86c4b8db0e614c12343f89ce974b91902e787f1fbd798005af0f140b51d7b929
Liberty,86c4b8db0e614c12343f89ce974b91902e787f1fbd798005af0f140b51d7b929,2760,259,3106,9,6134,Liberty86c4b8db0e614c12343f89ce974b91902e787f1fbd798005af0f140b51d7b929
Lincoln,86c4b8db0e614c12343f89ce974b91902e787f1fbd798005af0f140b51d7b929,1083,142,1534,0,2759,Lincoln86c4b8db0e614c12343f89ce974b91902e787f1fbd798005af0f140b51d7b929
Long,86c4b8db0e614c12343f89ce974b91902e787f1fbd798005af0f140b51d7b929,1337,41,1245,3,2626,Long86c4b8db0e614c12343f89ce974b91902e787f1fbd798005af0f140b51d7b929
Lowndes,86c4b8db0e614c12343f89ce974b91902e787f1fbd798005af0f140b51d7b929,6629,794,14006,206,21635,Lowndes86c4b8db0e614c12343f89ce974b91902e787f1fbd798005af0f140b51d7b929
Lumpkin,86c4b8db0e614c12343f89ce974b91902e787f1fbd798005af0f140b51d7b929,2163,395,7056,5,9619,Lumpkin86c4b8db0e614c12343f89ce974b91902e787f1fbd798005af0f140b51d7b929
Macon,86c4b8db0e614c12343f89ce974b91902e787f1fbd798005af0f140b51d7b929,493,68,979,0,1540,Macon86c4b8db0e614c12343f89ce974b91902e787f1fbd798005af0f140b51d7b929
Madison,86c4b8db0e614c12343f89ce974b91902e787f1fbd798005af0f140b51d7b929,4018,371,4806,6,9201,Madison86c4b8db0e614c12343f89ce974b91902e787f1fbd798005af0f140b51d7b929
Marion,86c4b8db0e614c12343f89ce974b91902e787f1fbd798005af0f140b51d7b929,1089,75,757,0,1921,Marion86c4b8db0e614c12343f89ce974b91902e787f1fbd798005af0f140b51d7b929
McDuffie,86c4b8db0e614c12343f89ce974b91902e787f1fbd798005af0f140b51d7b929,1886,273,3273,0,5432,McDuffie86c4b8db0e614c12343f89ce974b91902e787f1fbd798005af0f140b51d7b929
McIntosh,86c4b8db0e614c12343f89ce974b91902e787f1fbd798005af0f140b51d7b929,1254,375,1853,5,3487,McIntosh86c4b8db0e614c12343f89ce974b91902e787f1fbd798005af0f140b51d7b929
Meriwether,86c4b8db0e614c12343f89ce974b91902e787f1fbd798005af0f140b51d7b929,2967,200,2052,3,5222,Meriwether86c4b8db0e614c12343f89ce974b91902e787f1fbd798005af0f140b51d7b929
Miller,86c4b8db0e614c12343f89ce974b91902e787f1fbd798005af0f140b51d7b929,768,105,1015,3,1891,Miller86c4b8db0e614c12343f89ce974b91902e787f1fbd798005af0f140b51d7b929
Mitchell,86c4b8db0e614c12343f89ce974b91902e787f1fbd798005af0f140b51d7b929,2038,193,2041,7,4279,Mitchell86c4b8db0e614c12343f89ce974b91902e787f1fbd798005af0f140b51d7b929
Monroe,86c4b8db0e614c12343f89ce974b91902e787f1fbd798005af0f140b51d7b929,4103,303,4417,9,8832,Monroe86c4b8db0e614c12343f89ce974b91902e787f1fbd798005af0f140b51d7b929
Montgomery,86c4b8db0e614c12343f89ce974b91902e787f1fbd798005af0f140b51d7b929,1592,83,995,0,2670,Montgomery86c4b8db0e614c12343f89ce974b91902e787f1fbd798005af0f140b51d7b929
Morgan,86c4b8db0e614c12343f89ce974b91902e787f1fbd798005af0f140b51d7b929,2449,220,3888,2,6559,Morgan86c4b8db0e614c12343f89ce974b91902e787f1fbd798005af0f140b51d7b929
Murray,86c4b8db0e614c12343f89ce974b91902e787f1fbd798005af0f140b51d7b929,5212,258,4871,0,10341,Murray86c4b8db0e614c12343f89ce974b91902e787f1fbd798005af0f140b51d7b929
Muscogee,86c4b8db0e614c12343f89ce974b91902e787f1fbd798005af0f140b51d7b929,13014,1639,12299,24,26976,Muscogee86c4b8db0e614c12343f89ce974b91902e787f1fbd798005af0f140b51d7b929
Newton,86c4b8db0e614c12343f89ce974b91902e787f1fbd798005af0f140b51d7b929,10445,981,9485,2,20913,Newton86c4b8db0e614c12343f89ce974b91902e787f1fbd798005af0f140b51d7b929
Oconee,86c4b8db0e614c12343f89ce974b91902e787f1fbd798005af0f140b51d7b929,5105,535,7780,5,13425,Oconee86c4b8db0e614c12343f89ce974b91902e787f1fbd798005af0f140b51d7b929
Oglethorpe,86c4b8db0e614c12343f89ce974b91902e787f1fbd798005af0f140b51d7b929,1521,280,2823,1,4625,Oglethorpe86c4b8db0e614c12343f89ce974b91902e787f1fbd798005af0f140b51d7b929
Paulding,86c4b8db0e614c12343f89ce974b91902e787f1fbd798005af0f140b51d7b929,12163,2136,30350,13,44662,Paulding86c4b8db0e614c12343f89ce974b91902e787f1fbd798005af0f140b51d7b929
Peach,86c4b8db0e614c12343f89ce974b91902e787f1fbd798005af0f140b51d7b929,1481,169,3755,8,5413,Peach86c4b8db0e614c12343f89ce974b91902e787f1fbd798005af0f140b51d7b929
Pickens,86c4b8db0e614c12343f89ce974b91902e787f1fbd798005af0f140b51d7b929,4425,203,7022,1,11651,Pickens86c4b8db0e614c12343f89ce974b91902e787f1fbd798005af0f140b51d7b929
Pierce,86c4b8db0e614c12343f89ce974b91902e787f1fbd798005af0f140b51d7b929,1732,277,4292,1,6302,Pierce86c4b8db0e614c12343f89ce974b91902e787f1fbd798005af0f140b51d7b929
Pike,86c4b8db0e614c12343f89ce974b91902e787f1fbd798005af0f140b51d7b929,2649,280,4344,5,7278,Pike86c4b8db0e614c12343f89ce974b91902e787f1fbd798005af0f140b51d7b929
Polk,86c4b8db0e614c12343f89ce974b91902e787f1fbd798005af0f140b51d7b929,3373,345,7291,5,11014,Polk86c4b8db0e614c12343f89ce974b91902e787f1fbd798005af0f140b51d7b929
Pulaski,86c4b8db0e614c12343f89ce974b91902e787f1fbd798005af0f140b51d7b929,535,106,1795,1,2437,Pulaski86c4b8db0e614c12343f89ce974b91902e787f1fbd798005af0f140b51d7b929
Putnam,86c4b8db0e614c12343f89ce974b91902e787f1fbd798005af0f140b51d7b929,2306,358,3876,4,6544,Putnam86c4b8db0e614c12343f89ce974b91902e787f1fbd798005af0f140b51d7b929
Quitman,86c4b8db0e614c12343f89ce974b91902e787f1fbd798005af0f140b51d7b929,235,36,304,0,575,Quitman86c4b8db0e614c12343f89ce974b91902e787f1fbd798005af0f140b51d7b929
Rabun,86c4b8db0e614c12343f89ce974b91902e787f1fbd798005af0f140b51d7b929,1097,657,4533,0,6287,Rabun86c4b8db0e614c12343f89ce974b91902e787f1fbd798005af0f140b51d7b929
Randolph,86c4b8db0e614c12343f89ce974b91902e787f1fbd798005af0f140b51d7b929,655,34,581,1,1271,Randolph86c4b8db0e614c12343f89ce974b91902e787f1fbd798005af0f140b51d7b929
Richmond,86c4b8db0e614c12343f89ce974b91902e787f1fbd798005af0f140b51d7b929,12183,1556,10707,15,24461,Richmond86c4b8db0e614c12343f89ce974b91902e787f1fbd798005af0f140b51d7b929
Rockdale,86c4b8db0e614c12343f89ce974b91902e787f1fbd798005af0f140b51d7b929,3724,615,9132,7,13478,Rockdale86c4b8db0e614c12343f89ce974b91902e787f1fbd798005af0f140b51d7b929
Schley,86c4b8db0e614c12343f89ce974b91902e787f1fbd798005af0f140b51d7b929,422,49,1001,0,1472,Schley86c4b8db0e614c12343f89ce974b91902e787f1fbd798005af0f140b51d7b929
Screven,86c4b8db0e614c12343f89ce974b91902e787f1fbd798005af0f140b51d7b929,1473,88,1744,0,3305,Screven86c4b8db0e614c12343f89ce974b91902e787f1fbd798005af0f140b51d7b929
Seminole,86c4b8db0e614c12343f89ce974b91902e787f1fbd798005af0f140b51d7b929,1267,114,962,2,2345,Seminole86c4b8db0e614c12343f89ce974b91902e787f1fbd798005af0f140b51d7b929
Spalding,86c4b8db0e614c12343f89ce974b91902e787f1fbd798005af0f140b51d7b929,5461,614,9562,9,15646,Spalding86c4b8db0e614c12343f89ce974b91902e787f1fbd798005af0f140b51d7b929
Stephens,86c4b8db0e614c12343f89ce974b91902e787f1fbd798005af0f140b51d7b929,1470,465,5748,3,7686,Stephens86c4b8db0e614c12343f89ce974b91902e787f1fbd798005af0f140b51d7b929
Stewart,86c4b8db0e614c12343f89ce974b91902e787f1fbd798005af0f140b51d7b929,343,127,332,3,805,Stewart86c4b8db0e614c12343f89ce974b91902e787f1fbd798005af0f140b51d7b929
Sumter,86c4b8db0e614c12343f89ce974b91902e787f1fbd798005af0f140b51d7b929,2348,265,2662,1,5276,Sumter86c4b8db0e614c12343f89ce974b91902e787f1fbd798005af0f140b51d7b929
Talbot,86c4b8db0e614c12343f89ce974b91902e787f1fbd798005af0f140b51d7b929,746,100,350,0,1196,Talbot86c4b8db0e614c12343f89ce974b91902e787f1fbd798005af0f140b51d7b929
Taliaferro,86c4b8db0e614c12343f89ce974b91902e787f1fbd798005af0f140b51d7b929,166,18,165,0,349,Taliaferro86c4b8db0e614c12343f89ce974b91902e787f1fbd798005af0f140b51d7b929
Tattnall,86c4b8db0e614c12343f89ce974b91902e787f1fbd798005af0f140b51d7b929,1946,423,2724,3,5096,Tattnall86c4b8db0e614c12343f89ce974b91902e787f1fbd798005af0f140b51d7b929
Taylor,86c4b8db0e614c12343f89ce974b91902e787f1fbd798005af0f140b51d7b929,677,119,1268,0,2064,Taylor86c4b8db0e614c12343f89ce974b91902e787f1fbd798005af0f140b51d7b929
Telfair,86c4b8db0e614c12343f89ce974b91902e787f1fbd798005af0f140b51d7b929,1303,109,1037,1,2450,Telfair86c4b8db0e614c12343f89ce974b91902e787f1fbd798005af0f140b51d7b929
Terrell,86c4b8db0e614c12343f89ce974b91902e787f1fbd798005af0f140b51d7b929,870,96,906,2,1874,Terrell86c4b8db0e614c12343f89ce974b91902e787f1fbd798005af0f140b51d7b929
Thomas,86c4b8db0e614c12343f89ce974b91902e787f1fbd798005af0f140b51d7b929,4302,428,6495,3,11228,Thomas86c4b8db0e614c12343f89ce974b91902e787f1fbd798005af0f140b51d7b929
Tift,86c4b8db0e614c12343f89ce974b91902e787f1fbd798005af0f140b51d7b929,3634,344,5597,9,9584,Tift86c4b8db0e614c12343f89ce974b91902e787f1fbd798005af0f140b51d7b929
Toombs,86c4b8db0e614c12343f89ce974b91902e787f1fbd798005af0f140b51d7b929,2540,342,3731,2,6615,Toombs86c4b8db0e614c12343f89ce974b91902e787f1fbd798005af0f140b51d7b929
Towns,86c4b8db0e614c12343f89ce974b91902e787f1fbd798005af0f140b51d7b929,1448,309,3620,6,5383,Towns86c4b8db0e614c12343f89ce974b91902e787f1fbd798005af0f140b51d7b929
Treutlen,86c4b8db0e614c12343f89ce974b91902e787f1fbd798005af0f140b51d7b929,611,107,1090,1,1809,Treutlen86c4b8db0e614c12343f89ce974b91902e787f1fbd798005af0f140b51d7b929
Troup,86c4b8db0e614c12343f89ce974b91902e787f1fbd798005af0f140b51d7b929,6782,692,8169,107,15750,Troup86c4b8db0e614c12343f89ce974b91902e787f1fbd798005af0f140b51d7b929
Turner,86c4b8db0e614c12343f89ce974b91902e787f1fbd798005af0f140b51d7b929,609,55,1430,1,2095,Turner86c4b8db0e614c12343f89ce974b91902e787f1fbd798005af0f140b51d7b929
Twiggs,86c4b8db0e614c12343f89ce974b91902e787f1fbd798005af0f140b51d7b929,1154,87,793,1,2035,Twiggs86c4b8db0e614c12343f89ce974b91902e787f1fbd798005af0f140b51d7b929
Union,86c4b8db0e614c12343f89ce974b91902e787f1fbd798005af0f140b51d7b929,3341,449,6059,3,9852,Union86c4b8db0e614c12343f89ce974b91902e787f1fbd798005af0f140b51d7b929
Upson,86c4b8db0e614c12343f89ce974b91902e787f1fbd798005af0f140b51d7b929,1719,308,5261,4,7292,Upson86c4b8db0e614c12343f89ce974b91902e787f1fbd798005af0f140b51d7b929
Walker,86c4b8db0e614c12343f89ce974b91902e787f1fbd798005af0f140b51d7b929,7302,681,10960,7,18950,Walker86c4b8db0e614c12343f89ce974b91902e787f1fbd798005af0f140b51d7b929
Walton,86c4b8db0e614c12343f89ce974b91902e787f1fbd798005af0f140b51d7b929,15918,1228,13955,24,31125,Walton86c4b8db0e614c12343f89ce974b91902e787f1fbd798005af0f140b51d7b929
Ware,86c4b8db0e614c12343f89ce974b91902e787f1fbd798005af0f140b51d7b929,3671,358,4479,5,8513,Ware86c4b8db0e614c12343f89ce974b91902e787f1fbd798005af0f140b51d7b929
Warren,86c4b8db0e614c12343f89ce974b91902e787f1fbd798005af0f140b51d7b929,303,75,613,0,991,Warren86c4b8db0e614c12343f89ce974b91902e787f1fbd798005af0f140b51d7b929
Washington,86c4b8db0e614c12343f89ce974b91902e787f1fbd798005af0f140b51d7b929,1779,256,2103,11,4149,Washington86c4b8db0e614c12343f89ce974b91902e787f1fbd798005af0f140b51d7b929
Wayne,86c4b8db0e614c12343f89ce974b91902e787f1fbd798005af0f140b51d7b929,3408,310,4429,6,8153,Wayne86c4b8db0e614c12343f89ce974b91902e787f1fbd798005af0f140b51d7b929
Webster,86c4b8db0e614c12343f89ce974b91902e787f1fbd798005af0f140b51d7b929,241,66,323,0,630,Webster86c4b8db0e614c12343f89ce974b91902e787f1fbd798005af0f140b51d7b929
Wheeler,86c4b8db0e614c12343f89ce974b91902e787f1fbd798005af0f140b51d7b929,669,94,655,3,1421,Wheeler86c4b8db0e614c12343f89ce974b91902e787f1fbd798005af0f140b51d7b929
White,86c4b8db0e614c12343f89ce974b91902e787f1fbd798005af0f140b51d7b929,4042,482,5227,10,9761,White86c4b8db0e614c12343f89ce974b91902e787f1fbd798005af0f140b51d7b929
Whitfield,86c4b8db0e614c12343f89ce974b91902e787f1fbd798005af0f140b51d7b929,11057,751,9708,21,21537,Whitfield86c4b8db0e614c12343f89ce974b91902e787f1fbd798005af0f140b51d7b929
Wilcox,86c4b8db0e614c12343f89ce974b91902e787f1fbd798005af0f140b51d7b929,993,164,939,0,2096,Wilcox86c4b8db0e614c12343f89ce974b91902e787f1fbd798005af0f140b51d7b929
Wilkes,86c4b8db0e614c12343f89ce974b91902e787f1fbd798005af0f140b51d7b929,1161,88,1320,3,2572,Wilkes86c4b8db0e614c12343f89ce974b91902e787f1fbd798005af0f140b51d7b929
Wilkinson,86c4b8db0e614c12343f89ce974b91902e787f1fbd798005af0f140b51d7b929,1490,81,761,1,2333,Wilkinson86c4b8db0e614c12343f89ce974b91902e787f1fbd798005af0f140b51d7b929
Worth,86c4b8db0e614c12343f89ce974b91902e787f1fbd798005af0f140b51d7b929,3401,166,2578,7,6152,Worth86c4b8db0e614c12343f89ce974b91902e787f1fbd798005af0f140b51d7b929
Appling,08e5ad8dcf96fa2e9936cf2419f0cd5ef7fa6c81da9a38fbec6a572c27aca34c,677,159,598,0,1434,Appling08e5ad8dcf96fa2e9936cf2419f0cd5ef7fa6c81da9a38fbec6a572c27aca34c
Atkinson,08e5ad8dcf96fa2e9936cf2419f0cd5ef7fa6c81da9a38fbec6a572c27aca34c,367,30,299,1,697,Atkinson08e5ad8dcf96fa2e9936cf2419f0cd5ef7fa6c81da9a38fbec6a572c27aca34c
Bacon,08e5ad8dcf96fa2e9936cf2419f0cd5ef7fa6c81da9a38fbec6a572c27aca34c,268,37,303,0,608,Bacon08e5ad8dcf96fa2e9936cf2419f0cd5ef7fa6c81da9a38fbec6a572c27aca34c
Baker,08e5ad8dcf96fa2e9936cf2419f0cd5ef7fa6c81da9a38fbec6a572c27aca34c,319,69,261,1,650,Baker08e5ad8dcf96fa2e9936cf2419f0cd5ef7fa6c81da9a38fbec6a572c27aca34c
Baldwin,08e5ad8dcf96fa2e9936cf2419f0cd5ef7fa6c81da9a38fbec6a572c27aca34c,3143,724,4099,4,7970,Baldwin08e5ad8dcf96fa2e9936cf2419f0cd5ef7fa6c81da9a38fbec6a572c27aca34c
Banks,08e5ad8dcf96fa2e9936cf2419f0cd5ef7fa6c81da9a38fbec6a572c27aca34c,352,40,292,0,684,Banks08e5ad8dcf96fa2e9936cf2419f0cd5ef7fa6c81da9a38fbec6a572c27aca34c
Barrow,08e5ad8dcf96fa2e9936cf2419f0cd5ef7fa6c81da9a38fbec6a572c27aca34c,2832,371,3377,0,6580,Barrow08e5ad8dcf96fa2e9936cf2419f0cd5ef7fa6c81da9a38fbec6a572c27aca34c
Bartow,08e5ad8dcf96fa2e9936cf2419f0cd5ef7fa6c81da9a38fbec6a572c27aca34c,4051,440,3715,6,8212,Bartow08e5ad8dcf96fa2e9936cf2419f0cd5ef7fa6c81da9a38fbec6a572c27aca34c
Ben Hill,08e5ad8dcf96fa2e9936cf2419f0cd5ef7fa6c81da9a38fbec6a572c27aca34c,670,117,1311,3,2101,Ben Hill08e5ad8dcf96fa2e9936cf2419f0cd5ef7fa6c81da9a38fbec6a572c27aca34c
Berrien,08e5ad8dcf96fa2e9936cf2419f0cd5ef7fa6c81da9a38fbec6a572c27aca34c,508,90,444,5,1047,Berrien08e5ad8dcf96fa2e9936cf2419f0cd5ef7fa6c81da9a38fbec6a572c27aca34c
Bibb,08e5ad8dcf96fa2e9936cf2419f0cd5ef7fa6c81da9a38fbec6a572c27aca34c,16118,2241,18265,163,36787,Bibb08e5ad8dcf96fa2e9936cf2419f0cd5ef7fa6c81da9a38fbec6a572c27aca34c
Bleckley,08e5ad8dcf96fa2e9936cf2419f0cd5ef7fa6c81da9a38fbec6a572c27aca34c,479,113,502,7,1101,Bleckley08e5ad8dcf96fa2e9936cf2419f0cd5ef7fa6c81da9a38fbec6a572c27aca34c
Brantley,08e5ad8dcf96fa2e9936cf2419f0cd5ef7fa6c81da9a38fbec6a572c27aca34c,304,42,273,0,619,Brantley08e5ad8dcf96fa2e9936cf2419f0cd5ef7fa6c81da9a38fbec6a572c27aca34c
Brooks,08e5ad8dcf96fa2e9936cf2419f0cd5ef7fa6c81da9a38fbec6a572c27aca34c,1041,460,1003,24,2528,Brooks08e5ad8dcf96fa2e9936cf2419f0cd5ef7fa6c81da9a38fbec6a572c27aca34c
Bryan,08e5ad8dcf96fa2e9936cf2419f0cd5ef7fa6c81da9a38fbec6a572c27aca34c,1465,235,2312,2,4014,Bryan08e5ad8dcf96fa2e9936cf2419f0cd5ef7fa6c81da9a38fbec6a572c27aca34c
Bulloch,08e5ad8dcf96fa2e9936cf2419f0cd5ef7fa6c81da9a38fbec6a572c27aca34c,3961,430,4851,19,9261,Bulloch08e5ad8dcf96fa2e9936cf2419f0cd5ef7fa6c81da9a38fbec6a572c27aca34c
Burke,08e5ad8dcf96fa2e9936cf2419f0cd5ef7fa6c81da9a38fbec6a572c27aca34c,2484,654,1593,0,4731,Burke08e5ad8dcf96fa2e9936cf2419f0cd5ef7fa6c81da9a38fbec6a572c27aca34c
Butts,08e5ad8dcf96fa2e9936cf2419f0cd5ef7fa6c81da9a38fbec6a572c27aca34c,814,88,1664,0,2566,Butts08e5ad8dcf96fa2e9936cf2419f0cd5ef7fa6c81da9a38fbec6a572c27aca34c
Calhoun,08e5ad8dcf96fa2e9936cf2419f0cd5ef7fa6c81da9a38fbec6a572c27aca34c,751,106,321,1,1179,Calhoun08e5ad8dcf96fa2e9936cf2419f0cd5ef7fa6c81da9a38fbec6a572c27aca34c
Camden,08e5ad8dcf96fa2e9936cf2419f0cd5ef7fa6c81da9a38fbec6a572c27aca34c,2092,466,3364,8,5930,Camden08e5ad8dcf96fa2e9936cf2419f0cd5ef7fa6c81da9a38fbec6a572c27aca34c
Candler,08e5ad8dcf96fa2e9936cf2419f0cd5ef7fa6c81da9a38fbec6a572c27aca34c,380,46,597,3,1026,Candler08e5ad8dcf96fa2e9936cf2419f0cd5ef7fa6c81da9a38fbec6a572c27aca34c
Carroll,08e5ad8dcf96fa2e9936cf2419f0cd5ef7fa6c81da9a38fbec6a572c27aca34c,4983,543,6898,40,12464,Carroll08e5ad8dcf96fa2e9936cf2419f0cd5ef7fa6c81da9a38fbec6a572c27aca34c
Catoosa,08e5ad8dcf96fa2e9936cf2419f0cd5ef7fa6c81da9a38fbec6a572c27aca34c,1650,182,2937,2,4771,Catoosa08e5ad8dcf96fa2e9936cf2419f0cd5ef7fa6c81da9a38fbec6a572c27aca34c
Charlton,08e5ad8dcf96fa2e9936cf2419f0cd5ef7fa6c81da9a38fbec6a572c27aca34c,434,55,513,2,1004,Charlton08e5ad8dcf96fa2e9936cf2419f0cd5ef7fa6c81da9a38fbec6a572c27aca34c
Chatham,08e5ad8dcf96fa2e9936cf2419f0cd5ef7fa6c81da9a38fbec6a572c27aca34c,37801,3116,21310,63,62290,Chatham08e5ad8dcf96fa2e9936cf2419f0cd5ef7fa6c81da9a38fbec6a572c27aca34c
Chattahoochee,08e5ad8dcf96fa2e9936cf2419f0cd5ef7fa6c81da9a38fbec6a572c27aca34c,280,29,284,1,594,Chattahoochee08e5ad8dcf96fa2e9936cf2419f0cd5ef7fa6c81da9a38fbec6a572c27aca34c
Chattooga,08e5ad8dcf96fa2e9936cf2419f0cd5ef7fa6c81da9a38fbec6a572c27aca34c,703,82,827,1,1613,Chattooga08e5ad8dcf96fa2e9936cf2419f0cd5ef7fa6c81da9a38fbec6a572c27aca34c
Cherokee,08e5ad8dcf96fa2e9936cf2419f0cd5ef7fa6c81da9a38fbec6a572c27aca34c,10241,1574,13410,6,25231,Cherokee08e5ad8dcf96fa2e9936cf2419f0cd5ef7fa6c81da9a38fbec6a572c27aca34c
Clarke,08e5ad8dcf96fa2e9936cf2419f0cd5ef7fa6c81da9a38fbec6a572c27aca34c,11898,1648,15991,66,29603,Clarke08e5ad8dcf96fa2e9936cf2419f0cd5ef7fa6c81da9a38fbec6a572c27aca34c
Clay,08e5ad8dcf96fa2e9936cf2419f0cd5ef7fa6c81da9a38fbec6a572c27aca34c,366,69,261,1,697,Clay08e5ad8dcf96fa2e9936cf2419f0cd5ef7fa6c81da9a38fbec6a572c27aca34c
Clayton,08e5ad8dcf96fa2e9936cf2419f0cd5ef7fa6c81da9a38fbec6a572c27aca34c,28567,2179,47341,133,78220,Clayton08e5ad8dcf96fa2e9936cf2419f0cd5ef7fa6c81da9a38fbec6a572c27aca34c
Clinch,08e5ad8dcf96fa2e9936cf2419f0cd5ef7fa6c81da9a38fbec6a572c27aca34c,332,30,323,1,686,Clinch08e5ad8dcf96fa2e9936cf2419f0cd5ef7fa6c81da9a38fbec6a572c27aca34c
Cobb,08e5ad8dcf96fa2e9936cf2419f0cd5ef7fa6c81da9a38fbec6a572c27aca34c,75036,10124,74472,489,160121,Cobb08e5ad8dcf96fa2e9936cf2419f0cd5ef7fa6c81da9a38fbec6a572c27aca34c
Coffee,08e5ad8dcf96fa2e9936cf2419f0cd5ef7fa6c81da9a38fbec6a572c27aca34c,1642,168,2284,0,4094,Coffee08e5ad8dcf96fa2e9936cf2419f0cd5ef7fa6c81da9a38fbec6a572c27aca34c
Colquitt,08e5ad8dcf96fa2e9936cf2419f0cd5ef7fa6c81da9a38fbec6a572c27aca34c,1724,176,1561,2,3463,Colquitt08e5ad8dcf96fa2e9936cf2419f0cd5ef7fa6c81da9a38fbec6a572c27aca34c
Columbia,08e5ad8dcf96fa2e9936cf2419f0cd5ef7fa6c81da9a38fbec6a572c27aca34c,7328,1271,10279,9,18887,Columbia08e5ad8dcf96fa2e9936cf2419f0cd5ef7fa6c81da9a38fbec6a572c27aca34c
Cook,08e5ad8dcf96fa2e9936cf2419f0cd5ef7fa6c81da9a38fbec6a572c27aca34c,910,68,775,0,1753,Cook08e5ad8dcf96fa2e9936cf2419f0cd5ef7fa6c81da9a38fbec6a572c27aca34c
Coweta,08e5ad8dcf96fa2e9936cf2419f0cd5ef7fa6c81da9a38fbec6a572c27aca34c,7282,883,8411,7,16583,Coweta08e5ad8dcf96fa2e9936cf2419f0cd5ef7fa6c81da9a38fbec6a572c27aca34c
Crawford,08e5ad8dcf96fa2e9936cf2419f0cd5ef7fa6c81da9a38fbec6a572c27aca34c,598,95,726,2,1421,Crawford08e5ad8dcf96fa2e9936cf2419f0cd5ef7fa6c81da9a38fbec6a572c27aca34c
Crisp,08e5ad8dcf96fa2e9936cf2419f0cd5ef7fa6c81da9a38fbec6a572c27aca34c,1017,134,1684,2,2837,Crisp08e5ad8dcf96fa2e9936cf2419f0cd5ef7fa6c81da9a38fbec6a572c27aca34c
Dade,08e5ad8dcf96fa2e9936cf2419f0cd5ef7fa6c81da9a38fbec6a572c27aca34c,434,54,477,0,965,Dade08e5ad8dcf96fa2e9936cf2419f0cd5ef7fa6c81da9a38fbec6a572c27aca34c
Dawson,08e5ad8dcf96fa2e9936cf2419f0cd5ef7fa6c81da9a38fbec6a572c27aca34c,379,107,958,4,1448,Dawson08e5ad8dcf96fa2e9936cf2419f0cd5ef7fa6c81da9a38fbec6a572c27aca34c
Decatur,08e5ad8dcf96fa2e9936cf2419f0cd5ef7fa6c81da9a38fbec6a572c27aca34c,1798,240,2066,20,4124,Decatur08e5ad8dcf96fa2e9936cf2419f0cd5ef7fa6c81da9a38fbec6a572c27aca34c
DeKalb,08e5ad8dcf96fa2e9936cf2419f0cd5ef7fa6c81da9a38fbec6a572c27aca34c,90473,11786,148684,427,251370,DeKalb08e5ad8dcf96fa2e9936cf2419f0cd5ef7fa6c81da9a38fbec6a572c27aca34c
Dodge,08e5ad8dcf96fa2e9936cf2419f0cd5ef7fa6c81da9a38fbec6a572c27aca34c,940,97,800,2,1839,Dodge08e5ad8dcf96fa2e9936cf2419f0cd5ef7fa6c81da9a38fbec6a572c27aca34c
Dooly,08e5ad8dcf96fa2e9936cf2419f0cd5ef7fa6c81da9a38fbec6a572c27aca34c,1026,109,728,9,1872,Dooly08e5ad8dcf96fa2e9936cf2419f0cd5ef7fa6c81da9a38fbec6a572c27aca34c
Dougherty,08e5ad8dcf96fa2e9936cf2419f0cd5ef7fa6c81da9a38fbec6a572c27aca34c,11877,1063,10289,82,23311,Dougherty08e5ad8dcf96fa2e9936cf2419f0cd5ef7fa6c81da9a38fbec6a572c27aca34c
Douglas,08e5ad8dcf96fa2e9936cf2419f0cd5ef7fa6c81da9a38fbec6a572c27aca34c,10769,1148,19059,29,31005,Douglas08e5ad8dcf96fa2e9936cf2419f0cd5ef7fa6c81da9a38fbec6a572c27aca34c
Early,08e5ad8dcf96fa2e9936cf2419f0cd5ef7fa6c81da9a38fbec6a572c27aca34c,1087,213,867,1,2168,Early08e5ad8dcf96fa2e9936cf2419f0cd5ef7fa6c81da9a38fbec6a572c27aca34c
Echols,08e5ad8dcf96fa2e9936cf2419f0cd5ef7fa6c81da9a38fbec6a572c27aca34c,62,2,92,0,156,Echols08e5ad8dcf96fa2e9936cf2419f0cd5ef7fa6c81da9a38fbec6a572c27aca34c
Effingham,08e5ad8dcf96fa2e9936cf2419f0cd5ef7fa6c81da9a38fbec6a572c27aca34c,2360,213,2279,1,4853,Effingham08e5ad8dcf96fa2e9936cf2419f0cd5ef7fa6c81da9a38fbec6a572c27aca34c
Elbert,08e5ad8dcf96fa2e9936cf2419f0cd5ef7fa6c81da9a38fbec6a572c27aca34c,892,194,1421,32,2539,Elbert08e5ad8dcf96fa2e9936cf2419f0cd5ef7fa6c81da9a38fbec6a572c27aca34c
Emanuel,08e5ad8dcf96fa2e9936cf2419f0cd5ef7fa6c81da9a38fbec6a572c27aca34c,1326,114,993,2,2435,Emanuel08e5ad8dcf96fa2e9936cf2419f0cd5ef7fa6c81da9a38fbec6a572c27aca34c
Evans,08e5ad8dcf96fa2e9936cf2419f0cd5ef7fa6c81da9a38fbec6a572c27aca34c,410,60,660,0,1130,Evans08e5ad8dcf96fa2e9936cf2419f0cd5ef7fa6c81da9a38fbec6a572c27aca34c
Fannin,08e5ad8dcf96fa2e9936cf2419f0cd5ef7fa6c81da9a38fbec6a572c27aca34c,634,204,1082,3,1923,Fannin08e5ad8dcf96fa2e9936cf2419f0cd5ef7fa6c81da9a38fbec6a572c27aca34c
Fayette,08e5ad8dcf96fa2e9936cf2419f0cd5ef7fa6c81da9a38fbec6a572c27aca34c,6724,1156,15389,15,23284,Fayette08e5ad8dcf96fa2e9936cf2419f0cd5ef7fa6c81da9a38fbec6a572c27aca34c
Floyd,08e5ad8dcf96fa2e9936cf2419f0cd5ef7fa6c81da9a38fbec6a572c27aca34c,3551,523,5053,32,9159,Floyd08e5ad8dcf96fa2e9936cf2419f0cd5ef7fa6c81da9a38fbec6a572c27aca34c
Forsyth,08e5ad8dcf96fa2e9936cf2419f0cd5ef7fa6c81da9a38fbec6a572c27aca34c,6509,1253,15686,14,23462,Forsyth08e5ad8dcf96fa2e9936cf2419f0cd5ef7fa6c81da9a38fbec6a572c27aca34c
Franklin,08e5ad8dcf96fa2e9936cf2419f0cd5ef7fa6c81da9a38fbec6a572c27aca34c,633,87,523,0,1243,Franklin08e5ad8dcf96fa2e9936cf2419f0cd5ef7fa6c81da9a38fbec6a572c27aca34c
Fulton,08e5ad8dcf96fa2e9936cf2419f0cd5ef7fa6c81da9a38fbec6a572c27aca34c,104280,14136,177683,952,297051,Fulton08e5ad8dcf96fa2e9936cf2419f0cd5ef7fa6c81da9a38fbec6a572c27aca34c
Gilmer,08e5ad8dcf96fa2e9936cf2419f0cd5ef7fa6c81da9a38fbec6a572c27aca34c,691,149,1121,4,1965,Gilmer08e5ad8dcf96fa2e9936cf2419f0cd5ef7fa6c81da9a38fbec6a572c27aca34c
Glascock,08e5ad8dcf96fa2e9936cf2419f0cd5ef7fa6c81da9a38fbec6a572c27aca34c,75,15,48,0,138,Glascock08e5ad8dcf96fa2e9936cf2419f0cd5ef7fa6c81da9a38fbec6a572c27aca34c
Glynn,08e5ad8dcf96fa2e9936cf2419f0cd5ef7fa6c81da9a38fbec6a572c27aca34c,4685,747,6309,34,11775,Glynn08e5ad8dcf96fa2e9936cf2419f0cd5ef7fa6c81da9a38fbec6a572c27aca34c
Gordon,08e5ad8dcf96fa2e9936cf2419f0cd5ef7fa6c81da9a38fbec6a572c27aca34c,1432,157,1587,5,3181,Gordon08e5ad8dcf96fa2e9936cf2419f0cd5ef7fa6c81da9a38fbec6a572c27aca34c
Grady,08e5ad8dcf96fa2e9936cf2419f0cd5ef7fa6c81da9a38fbec6a572c27aca34c,1199,107,1699,8,3013,Grady08e5ad8dcf96fa2e9936cf2419f0cd5ef7fa6c81da9a38fbec6a572c27aca34c
Greene,08e5ad8dcf96fa2e9936cf2419f0cd5ef7fa6c81da9a38fbec6a572c27aca34c,1171,391,1633,4,3199,Greene08e5ad8dcf96fa2e9936cf2419f0cd5ef7fa6c81da9a38fbec6a572c27aca34c
Gwinnett,08e5ad8dcf96fa2e9936cf2419f0cd5ef7fa6c81da9a38fbec6a572c27aca34c,77090,7498,80576,989,166153,Gwinnett08e5ad8dcf96fa2e9936cf2419f0cd5ef7fa6c81da9a38fbec6a572c27aca34c
Habersham,08e5ad8dcf96fa2e9936cf2419f0cd5ef7fa6c81da9a38fbec6a572c27aca34c,592,203,1688,0,2483,Habersham08e5ad8dcf96fa2e9936cf2419f0cd5ef7fa6c81da9a38fbec6a572c27aca34c
Hall,08e5ad8dcf96fa2e9936cf2419f0cd5ef7fa6c81da9a38fbec6a572c27aca34c,7161,1081,7920,18,16180,Hall08e5ad8dcf96fa2e9936cf2419f0cd5ef7fa6c81da9a38fbec6a572c27aca34c
Hancock,08e5ad8dcf96fa2e9936cf2419f0cd5ef7fa6c81da9a38fbec6a572c27aca34c,1361,303,1031,6,2701,Hancock08e5ad8dcf96fa2e9936cf2419f0cd5ef7fa6c81da9a38fbec6a572c27aca34c
Haralson,08e5ad8dcf96fa2e9936cf2419f0cd5ef7fa6c81da9a38fbec6a572c27aca34c,715,109,650,1,1475,Haralson08e5ad8dcf96fa2e9936cf2419f0cd5ef7fa6c81da9a38fbec6a572c27aca34c
Harris,08e5ad8dcf96fa2e9936cf2419f0cd5ef7fa6c81da9a38fbec6a572c27aca34c,1733,225,2128,0,4086,Harris08e5ad8dcf96fa2e9936cf2419f0cd5ef7fa6c81da9a38fbec6a572c27aca34c
Hart,08e5ad8dcf96fa2e9936cf2419f0cd5ef7fa6c81da9a38fbec6a572c27aca34c,1019,182,1384,0,2585,Hart08e5ad8dcf96fa2e9936cf2419f0cd5ef7fa6c81da9a38fbec6a572c27aca34c
Heard,08e5ad8dcf96fa2e9936cf2419f0cd5ef7fa6c81da9a38fbec6a572c27aca34c,351,70,321,1,743,Heard08e5ad8dcf96fa2e9936cf2419f0cd5ef7fa6c81da9a38fbec6a572c27aca34c
Henry,08e5ad8dcf96fa2e9936cf2419f0cd5ef7fa6c81da9a38fbec6a572c27aca34c,13630,1645,34664,118,50057,Henry08e5ad8dcf96fa2e9936cf2419f0cd5ef7fa6c81da9a38fbec6a572c27aca34c
Houston,08e5ad8dcf96fa2e9936cf2419f0cd5ef7fa6c81da9a38fbec6a572c27aca34c,7537,1085,13860,71,22553,Houston08e5ad8dcf96fa2e9936cf2419f0cd5ef7fa6c81da9a38fbec6a572c27aca34c
Irwin,08e5ad8dcf96fa2e9936cf2419f0cd5ef7fa6c81da9a38fbec6a572c27aca34c,397,40,454,0,891,Irwin08e5ad8dcf96fa2e9936cf2419f0cd5ef7fa6c81da9a38fbec6a572c27aca34c
Jackson,08e5ad8dcf96fa2e9936cf2419f0cd5ef7fa6c81da9a38fbec6a572c27aca34c,1661,152,2656,22,4491,Jackson08e5ad8dcf96fa2e9936cf2419f0cd5ef7fa6c81da9a38fbec6a572c27aca34c
Jasper,08e5ad8dcf96fa2e9936cf2419f0cd5ef7fa6c81da9a38fbec6a572c27aca34c,554,162,828,0,1544,Jasper08e5ad8dcf96fa2e9936cf2419f0cd5ef7fa6c81da9a38fbec6a572c27aca34c
Jeff Davis,08e5ad8dcf96fa2e9936cf2419f0cd5ef7fa6c81da9a38fbec6a572c27aca34c,478,37,386,0,901,Jeff Davis08e5ad8dcf96fa2e9936cf2419f0cd5ef7fa6c81da9a38fbec6a572c27aca34c
Jefferson,08e5ad8dcf96fa2e9936cf2419f0cd5ef7fa6c81da9a38fbec6a572c27aca34c,2001,345,1465,10,3821,Jefferson08e5ad8dcf96fa2e9936cf2419f0cd5ef7fa6c81da9a38fbec6a572c27aca34c
Jenkins,08e5ad8dcf96fa2e9936cf2419f0cd5ef7fa6c81da9a38fbec6a572c27aca34c,529,78,501,15,1123,Jenkins08e5ad8dcf96fa2e9936cf2419f0cd5ef7fa6c81da9a38fbec6a572c27aca34c
Johnson,08e5ad8dcf96fa2e9936cf2419f0cd5ef7fa6c81da9a38fbec6a572c27aca34c,472,150,514,0,1136,Johnson08e5ad8dcf96fa2e9936cf2419f0cd5ef7fa6c81da9a38fbec6a572c27aca34c
Jones,08e5ad8dcf96fa2e9936cf2419f0cd5ef7fa6c81da9a38fbec6a572c27aca34c,1416,325,2220,0,3961,Jones08e5ad8dcf96fa2e9936cf2419f0cd5ef7fa6c81da9a38fbec6a572c27aca34c
Lamar,08e5ad8dcf96fa2e9936cf2419f0cd5ef7fa6c81da9a38fbec6a572c27aca34c,852,146,1269,3,2270,Lamar08e5ad8dcf96fa2e9936cf2419f0cd5ef7fa6c81da9a38fbec6a572c27aca34c
Lanier,08e5ad8dcf96fa2e9936cf2419f0cd5ef7fa6c81da9a38fbec6a572c27aca34c,332,24,449,1,806,Lanier08e5ad8dcf96fa2e9936cf2419f0cd5ef7fa6c81da9a38fbec6a572c27aca34c
Laurens,08e5ad8dcf96fa2e9936cf2419f0cd5ef7fa6c81da9a38fbec6a572c27aca34c,3273,469,3009,1,6752,Laurens08e5ad8dcf96fa2e9936cf2419f0cd5ef7fa6c81da9a38fbec6a572c27aca34c
Lee,08e5ad8dcf96fa2e9936cf2419f0cd5ef7fa6c81da9a38fbec6a572c27aca34c,1491,158,1518,3,3170,Lee08e5ad8dcf96fa2e9936cf2419f0cd5ef7fa6c81da9a38fbec6a572c27aca34c
Liberty,08e5ad8dcf96fa2e9936cf2419f0cd5ef7fa6c81da9a38fbec6a572c27aca34c,3358,340,5833,25,9556,Liberty08e5ad8dcf96fa2e9936cf2419f0cd5ef7fa6c81da9a38fbec6a572c27aca34c
Lincoln,08e5ad8dcf96fa2e9936cf2419f0cd5ef7fa6c81da9a38fbec6a572c27aca34c,479,237,556,1,1273,Lincoln08e5ad8dcf96fa2e9936cf2419f0cd5ef7fa6c81da9a38fbec6a572c27aca34c
Long,08e5ad8dcf96fa2e9936cf2419f0cd5ef7fa6c81da9a38fbec6a572c27aca34c,637,53,666,4,1360,Long08e5ad8dcf96fa2e9936cf2419f0cd5ef7fa6c81da9a38fbec6a572c27aca34c
Lowndes,08e5ad8dcf96fa2e9936cf2419f0cd5ef7fa6c81da9a38fbec6a572c27aca34c,4423,700,9644,297,15064,Lowndes08e5ad8dcf96fa2e9936cf2419f0cd5ef7fa6c81da9a38fbec6a572c27aca34c
Lumpkin,08e5ad8dcf96fa2e9936cf2419f0cd5ef7fa6c81da9a38fbec6a572c27aca34c,502,132,1584,2,2220,Lumpkin08e5ad8dcf96fa2e9936cf2419f0cd5ef7fa6c81da9a38fbec6a572c27aca34c
Macon,08e5ad8dcf96fa2e9936cf2419f0cd5ef7fa6c81da9a38fbec6a572c27aca34c,1295,177,1233,0,2705,Macon08e5ad8dcf96fa2e9936cf2419f0cd5ef7fa6c81da9a38fbec6a572c27aca34c
Madison,08e5ad8dcf96fa2e9936cf2419f0cd5ef7fa6c81da9a38fbec6a572c27aca34c,1054,127,1244,0,2425,Madison08e5ad8dcf96fa2e9936cf2419f0cd5ef7fa6c81da9a38fbec6a572c27aca34c
Marion,08e5ad8dcf96fa2e9936cf2419f0cd5ef7fa6c81da9a38fbec6a572c27aca34c,496,188,529,0,1213,Marion08e5ad8dcf96fa2e9936cf2419f0cd5ef7fa6c81da9a38fbec6a572c27aca34c
McDuffie,08e5ad8dcf96fa2e9936cf2419f0cd5ef7fa6c81da9a38fbec6a572c27aca34c,1411,290,1998,0,3699,McDuffie08e5ad8dcf96fa2e9936cf2419f0cd5ef7fa6c81da9a38fbec6a572c27aca34c
McIntosh,08e5ad8dcf96fa2e9936cf2419f0cd5ef7fa6c81da9a38fbec6a572c27aca34c,956,228,1114,5,2303,McIntosh08e5ad8dcf96fa2e9936cf2419f0cd5ef7fa6c81da9a38fbec6a572c27aca34c
Meriwether,08e5ad8dcf96fa2e9936cf2419f0cd5ef7fa6c81da9a38fbec6a572c27aca34c,2275,199,1327,3,3804,Meriwether08e5ad8dcf96fa2e9936cf2419f0cd5ef7fa6c81da9a38fbec6a572c27aca34c
Miller,08e5ad8dcf96fa2e9936cf2419f0cd5ef7fa6c81da9a38fbec6a572c27aca34c,359,47,216,1,623,Miller08e5ad8dcf96fa2e9936cf2419f0cd5ef7fa6c81da9a38fbec6a572c27aca34c
Mitchell,08e5ad8dcf96fa2e9936cf2419f0cd5ef7fa6c81da9a38fbec6a572c27aca34c,1461,378,1653,1,3493,Mitchell08e5ad8dcf96fa2e9936cf2419f0cd5ef7fa6c81da9a38fbec6a572c27aca34c
Monroe,08e5ad8dcf96fa2e9936cf2419f0cd5ef7fa6c81da9a38fbec6a572c27aca34c,1419,249,1902,1,3571,Monroe08e5ad8dcf96fa2e9936cf2419f0cd5ef7fa6c81da9a38fbec6a572c27aca34c
Montgomery,08e5ad8dcf96fa2e9936cf2419f0cd5ef7fa6c81da9a38fbec6a572c27aca34c,520,43,284,0,847,Montgomery08e5ad8dcf96fa2e9936cf2419f0cd5ef7fa6c81da9a38fbec6a572c27aca34c
Morgan,08e5ad8dcf96fa2e9936cf2419f0cd5ef7fa6c81da9a38fbec6a572c27aca34c,958,161,1541,3,2663,Morgan08e5ad8dcf96fa2e9936cf2419f0cd5ef7fa6c81da9a38fbec6a572c27aca34c
Murray,08e5ad8dcf96fa2e9936cf2419f0cd5ef7fa6c81da9a38fbec6a572c27aca34c,938,96,766,0,1800,Murray08e5ad8dcf96fa2e9936cf2419f0cd5ef7fa6c81da9a38fbec6a572c27aca34c
Muscogee,08e5ad8dcf96fa2e9936cf2419f0cd5ef7fa6c81da9a38fbec6a572c27aca34c,16828,2174,20755,94,39851,Muscogee08e5ad8dcf96fa2e9936cf2419f0cd5ef7fa6c81da9a38fbec6a572c27aca34c
Newton,08e5ad8dcf96fa2e9936cf2419f0cd5ef7fa6c81da9a38fbec6a572c27aca34c,8927,980,12035,1,21943,Newton08e5ad8dcf96fa2e9936cf2419f0cd5ef7fa6c81da9a38fbec6a572c27aca34c
Oconee,08e5ad8dcf96fa2e9936cf2419f0cd5ef7fa6c81da9a38fbec6a572c27aca34c,1904,326,3349,2,5581,Oconee08e5ad8dcf96fa2e9936cf2419f0cd5ef7fa6c81da9a38fbec6a572c27aca34c
Oglethorpe,08e5ad8dcf96fa2e9936cf2419f0cd5ef7fa6c81da9a38fbec6a572c27aca34c,707,81,1042,1,1831,Oglethorpe08e5ad8dcf96fa2e9936cf2419f0cd5ef7fa6c81da9a38fbec6a572c27aca34c
Paulding,08e5ad8dcf96fa2e9936cf2419f0cd5ef7fa6c81da9a38fbec6a572c27aca34c,5688,889,11437,11,18025,Paulding08e5ad8dcf96fa2e9936cf2419f0cd5ef7fa6c81da9a38fbec6a572c27aca34c
Peach,08e5ad8dcf96fa2e9936cf2419f0cd5ef7fa6c81da9a38fbec6a572c27aca34c,1669,186,3228,17,5100,Peach08e5ad8dcf96fa2e9936cf2419f0cd5ef7fa6c81da9a38fbec6a572c27aca34c
Pickens,08e5ad8dcf96fa2e9936cf2419f0cd5ef7fa6c81da9a38fbec6a572c27aca34c,670,70,1237,2,1979,Pickens08e5ad8dcf96fa2e9936cf2419f0cd5ef7fa6c81da9a38fbec6a572c27aca34c
Pierce,08e5ad8dcf96fa2e9936cf2419f0cd5ef7fa6c81da9a38fbec6a572c27aca34c,270,65,568,0,903,Pierce08e5ad8dcf96fa2e9936cf2419f0cd5ef7fa6c81da9a38fbec6a572c27aca34c
Pike,08e5ad8dcf96fa2e9936cf2419f0cd5ef7fa6c81da9a38fbec6a572c27aca34c,471,77,691,1,1240,Pike08e5ad8dcf96fa2e9936cf2419f0cd5ef7fa6c81da9a38fbec6a572c27aca34c
Polk,08e5ad8dcf96fa2e9936cf2419f0cd5ef7fa6c81da9a38fbec6a572c27aca34c,964,113,1788,2,2867,Polk08e5ad8dcf96fa2e9936cf2419f0cd5ef7fa6c81da9a38fbec6a572c27aca34c
Pulaski,08e5ad8dcf96fa2e9936cf2419f0cd5ef7fa6c81da9a38fbec6a572c27aca34c,342,96,666,0,1104,Pulaski08e5ad8dcf96fa2e9936cf2419f0cd5ef7fa6c81da9a38fbec6a572c27aca34c
Putnam,08e5ad8dcf96fa2e9936cf2419f0cd5ef7fa6c81da9a38fbec6a572c27aca34c,1077,244,1435,2,2758,Putnam08e5ad8dcf96fa2e9936cf2419f0cd5ef7fa6c81da9a38fbec6a572c27aca34c
Quitman,08e5ad8dcf96fa2e9936cf2419f0cd5ef7fa6c81da9a38fbec6a572c27aca34c,246,18,197,0,461,Quitman08e5ad8dcf96fa2e9936cf2419f0cd5ef7fa6c81da9a38fbec6a572c27aca34c
Rabun,08e5ad8dcf96fa2e9936cf2419f0cd5ef7fa6c81da9a38fbec6a572c27aca34c,221,216,1007,0,1444,Rabun08e5ad8dcf96fa2e9936cf2419f0cd5ef7fa6c81da9a38fbec6a572c27aca34c
Randolph,08e5ad8dcf96fa2e9936cf2419f0cd5ef7fa6c81da9a38fbec6a572c27aca34c,760,152,685,1,1598,Randolph08e5ad8dcf96fa2e9936cf2419f0cd5ef7fa6c81da9a38fbec6a572c27aca34c
Richmond,08e5ad8dcf96fa2e9936cf2419f0cd5ef7fa6c81da9a38fbec6a572c27aca34c,21676,2804,24246,88,48814,Richmond08e5ad8dcf96fa2e9936cf2419f0cd5ef7fa6c81da9a38fbec6a572c27aca34c
Rockdale,08e5ad8dcf96fa2e9936cf2419f0cd5ef7fa6c81da9a38fbec6a572c27aca34c,6190,780,16260,25,23255,Rockdale08e5ad8dcf96fa2e9936cf2419f0cd5ef7fa6c81da9a38fbec6a572c27aca34c
Schley,08e5ad8dcf96fa2e9936cf2419f0cd5ef7fa6c81da9a38fbec6a572c27aca34c,146,35,220,0,401,Schley08e5ad8dcf96fa2e9936cf2419f0cd5ef7fa6c81da9a38fbec6a572c27aca34c
Screven,08e5ad8dcf96fa2e9936cf2419f0cd5ef7fa6c81da9a38fbec6a572c27aca34c,1245,87,968,0,2300,Screven08e5ad8dcf96fa2e9936cf2419f0cd5ef7fa6c81da9a38fbec6a572c27aca34c
Seminole,08e5ad8dcf96fa2e9936cf2419f0cd5ef7fa6c81da9a38fbec6a572c27aca34c,682,54,450,3,1189,Seminole08e5ad8dcf96fa2e9936cf2419f0cd5ef7fa6c81da9a38fbec6a572c27aca34c
Spalding,08e5ad8dcf96fa2e9936cf2419f0cd5ef7fa6c81da9a38fbec6a572c27aca34c,3756,417,5176,8,9357,Spalding08e5ad8dcf96fa2e9936cf2419f0cd5ef7fa6c81da9a38fbec6a572c27aca34c
Stephens,08e5ad8dcf96fa2e9936cf2419f0cd5ef7fa6c81da9a38fbec6a572c27aca34c,447,151,1239,0,1837,Stephens08e5ad8dcf96fa2e9936cf2419f0cd5ef7fa6c81da9a38fbec6a572c27aca34c
Stewart,08e5ad8dcf96fa2e9936cf2419f0cd5ef7fa6c81da9a38fbec6a572c27aca34c,587,221,412,2,1222,Stewart08e5ad8dcf96fa2e9936cf2419f0cd5ef7fa6c81da9a38fbec6a572c27aca34c
Sumter,08e5ad8dcf96fa2e9936cf2419f0cd5ef7fa6c81da9a38fbec6a572c27aca34c,2127,450,2943,0,5520,Sumter08e5ad8dcf96fa2e9936cf2419f0cd5ef7fa6c81da9a38fbec6a572c27aca34c
Talbot,08e5ad8dcf96fa2e9936cf2419f0cd5ef7fa6c81da9a38fbec6a572c27aca34c,1089,448,465,0,2002,Talbot08e5ad8dcf96fa2e9936cf2419f0cd5ef7fa6c81da9a38fbec6a572c27aca34c
Taliaferro,08e5ad8dcf96fa2e9936cf2419f0cd5ef7fa6c81da9a38fbec6a572c27aca34c,220,89,235,1,545,Taliaferro08e5ad8dcf96fa2e9936cf2419f0cd5ef7fa6c81da9a38fbec6a572c27aca34c
Tattnall,08e5ad8dcf96fa2e9936cf2419f0cd5ef7fa6c81da9a38fbec6a572c27aca34c,678,126,874,3,1681,Tattnall08e5ad8dcf96fa2e9936cf2419f0cd5ef7fa6c81da9a38fbec6a572c27aca34c
Taylor,08e5ad8dcf96fa2e9936cf2419f0cd5ef7fa6c81da9a38fbec6a572c27aca34c,655,176,465,0,1296,Taylor08e5ad8dcf96fa2e9936cf2419f0cd5ef7fa6c81da9a38fbec6a572c27aca34c
Telfair,08e5ad8dcf96fa2e9936cf2419f0cd5ef7fa6c81da9a38fbec6a572c27aca34c,657,225,431,0,1313,Telfair08e5ad8dcf96fa2e9936cf2419f0cd5ef7fa6c81da9a38fbec6a572c27aca34c
Terrell,08e5ad8dcf96fa2e9936cf2419f0cd5ef7fa6c81da9a38fbec6a572c27aca34c,1093,164,1010,0,2267,Terrell08e5ad8dcf96fa2e9936cf2419f0cd5ef7fa6c81da9a38fbec6a572c27aca34c
Thomas,08e5ad8dcf96fa2e9936cf2419f0cd5ef7fa6c81da9a38fbec6a572c27aca34c,2823,406,3912,1,7142,Thomas08e5ad8dcf96fa2e9936cf2419f0cd5ef7fa6c81da9a38fbec6a572c27aca34c
Tift,08e5ad8dcf96fa2e9936cf2419f0cd5ef7fa6c81da9a38fbec6a572c27aca34c,1735,198,2408,6,4347,Tift08e5ad8dcf96fa2e9936cf2419f0cd5ef7fa6c81da9a38fbec6a572c27aca34c
Toombs,08e5ad8dcf96fa2e9936cf2419f0cd5ef7fa6c81da9a38fbec6a572c27aca34c,1071,256,1011,0,2338,Toombs08e5ad8dcf96fa2e9936cf2419f0cd5ef7fa6c81da9a38fbec6a572c27aca34c
Towns,08e5ad8dcf96fa2e9936cf2419f0cd5ef7fa6c81da9a38fbec6a572c27aca34c,307,91,808,4,1210,Towns08e5ad8dcf96fa2e9936cf2419f0cd5ef7fa6c81da9a38fbec6a572c27aca34c
Treutlen,08e5ad8dcf96fa2e9936cf2419f0cd5ef7fa6c81da9a38fbec6a572c27aca34c,296,59,505,2,862,Treutlen08e5ad8dcf96fa2e9936cf2419f0cd5ef7fa6c81da9a38fbec6a572c27aca34c
Troup,08e5ad8dcf96fa2e9936cf2419f0cd5ef7fa6c81da9a38fbec6a572c27aca34c,4768,534,4295,116,9713,Troup08e5ad8dcf96fa2e9936cf2419f0cd5ef7fa6c81da9a38fbec6a572c27aca34c
Turner,08e5ad8dcf96fa2e9936cf2419f0cd5ef7fa6c81da9a38fbec6a572c27aca34c,569,30,644,3,1246,Turner08e5ad8dcf96fa2e9936cf2419f0cd5ef7fa6c81da9a38fbec6a572c27aca34c
Twiggs,08e5ad8dcf96fa2e9936cf2419f0cd5ef7fa6c81da9a38fbec6a572c27aca34c,960,240,771,0,1971,Twiggs08e5ad8dcf96fa2e9936cf2419f0cd5ef7fa6c81da9a38fbec6a572c27aca34c
Union,08e5ad8dcf96fa2e9936cf2419f0cd5ef7fa6c81da9a38fbec6a572c27aca34c,537,172,1253,1,1963,Union08e5ad8dcf96fa2e9936cf2419f0cd5ef7fa6c81da9a38fbec6a572c27aca34c
Upson,08e5ad8dcf96fa2e9936cf2419f0cd5ef7fa6c81da9a38fbec6a572c27aca34c,1246,147,2079,3,3475,Upson08e5ad8dcf96fa2e9936cf2419f0cd5ef7fa6c81da9a38fbec6a572c27aca34c
Walker,08e5ad8dcf96fa2e9936cf2419f0cd5ef7fa6c81da9a38fbec6a572c27aca34c,1651,274,2288,2,4215,Walker08e5ad8dcf96fa2e9936cf2419f0cd5ef7fa6c81da9a38fbec6a572c27aca34c
Walton,08e5ad8dcf96fa2e9936cf2419f0cd5ef7fa6c81da9a38fbec6a572c27aca34c,4122,447,3712,11,8292,Walton08e5ad8dcf96fa2e9936cf2419f0cd5ef7fa6c81da9a38fbec6a572c27aca34c
Ware,08e5ad8dcf96fa2e9936cf2419f0cd5ef7fa6c81da9a38fbec6a572c27aca34c,1047,219,2170,4,3440,Ware08e5ad8dcf96fa2e9936cf2419f0cd5ef7fa6c81da9a38fbec6a572c27aca34c
Warren,08e5ad8dcf96fa2e9936cf2419f0cd5ef7fa6c81da9a38fbec6a572c27aca34c,654,62,597,1,1314,Warren08e5ad8dcf96fa2e9936cf2419f0cd5ef7fa6c81da9a38fbec6a572c27aca34c
Washington,08e5ad8dcf96fa2e9936cf2419f0cd5ef7fa6c81da9a38fbec6a572c27aca34c,1824,444,1919,13,4200,Washington08e5ad8dcf96fa2e9936cf2419f0cd5ef7fa6c81da9a38fbec6a572c27aca34c
Wayne,08e5ad8dcf96fa2e9936cf2419f0cd5ef7fa6c81da9a38fbec6a572c27aca34c,809,85,1145,2,2041,Wayne08e5ad8dcf96fa2e9936cf2419f0cd5ef7fa6c81da9a38fbec6a572c27aca34c
Webster,08e5ad8dcf96fa2e9936cf2419f0cd5ef7fa6c81da9a38fbec6a572c27aca34c,241,61,169,2,473,Webster08e5ad8dcf96fa2e9936cf2419f0cd5ef7fa6c81da9a38fbec6a572c27aca34c
Wheeler,08e5ad8dcf96fa2e9936cf2419f0cd5ef7fa6c81da9a38fbec6a572c27aca34c,295,68,283,0,646,Wheeler08e5ad8dcf96fa2e9936cf2419f0cd5ef7fa6c81da9a38fbec6a572c27aca34c
White,08e5ad8dcf96fa2e9936cf2419f0cd5ef7fa6c81da9a38fbec6a572c27aca34c,588,120,964,2,1674,White08e5ad8dcf96fa2e9936cf2419f0cd5ef7fa6c81da9a38fbec6a572c27aca34c
Whitfield,08e5ad8dcf96fa2e9936cf2419f0cd5ef7fa6c81da9a38fbec6a572c27aca34c,4220,385,3321,11,7937,Whitfield08e5ad8dcf96fa2e9936cf2419f0cd5ef7fa6c81da9a38fbec6a572c27aca34c
Wilcox,08e5ad8dcf96fa2e9936cf2419f0cd5ef7fa6c81da9a38fbec6a572c27aca34c,573,46,233,0,852,Wilcox08e5ad8dcf96fa2e9936cf2419f0cd5ef7fa6c81da9a38fbec6a572c27aca34c
Wilkes,08e5ad8dcf96fa2e9936cf2419f0cd5ef7fa6c81da9a38fbec6a572c27aca34c,961,95,788,4,1848,Wilkes08e5ad8dcf96fa2e9936cf2419f0cd5ef7fa6c81da9a38fbec6a572c27aca34c
Wilkinson,08e5ad8dcf96fa2e9936cf2419f0cd5ef7fa6c81da9a38fbec6a572c27aca34c,1005,124,763,2,1894,Wilkinson08e5ad8dcf96fa2e9936cf2419f0cd5ef7fa6c81da9a38fbec6a572c27aca34c
Worth,08e5ad8dcf96fa2e9936cf2419f0cd5ef7fa6c81da9a38fbec6a572c27aca34c,1001,99,916,4,2020,Worth08e5ad8dcf96fa2e9936cf2419f0cd5ef7fa6c81da9a38fbec6a572c27aca34c
Appling,354e279fb5421e120f1a02b4fdbc0776b5d0ad3c04ebcbaa646d586eb899468c,41,9,27,0,77,Appling354e279fb5421e120f1a02b4fdbc0776b5d0ad3c04ebcbaa646d586eb899468c
Atkinson,354e279fb5421e120f1a02b4fdbc0776b5d0ad3c04ebcbaa646d586eb899468c,24,1,10,0,35,Atkinson354e279fb5421e120f1a02b4fdbc0776b5d0ad3c04ebcbaa646d586eb899468c
Bacon,354e279fb5421e120f1a02b4fdbc0776b5d0ad3c04ebcbaa646d586eb899468c,21,4,22,0,47,Bacon354e279fb5421e120f1a02b4fdbc0776b5d0ad3c04ebcbaa646d586eb899468c
Baker,354e279fb5421e120f1a02b4fdbc0776b5d0ad3c04ebcbaa646d586eb899468c,11,1,3,0,15,Baker354e279fb5421e120f1a02b4fdbc0776b5d0ad3c04ebcbaa646d586eb899468c
Baldwin,354e279fb5421e120f1a02b4fdbc0776b5d0ad3c04ebcbaa646d586eb899468c,192,27,200,0,419,Baldwin354e279fb5421e120f1a02b4fdbc0776b5d0ad3c04ebcbaa646d586eb899468c
Banks,354e279fb5421e120f1a02b4fdbc0776b5d0ad3c04ebcbaa646d586eb899468c,77,6,49,0,132,Banks354e279fb5421e120f1a02b4fdbc0776b5d0ad3c04ebcbaa646d586eb899468c
Barrow,354e279fb5421e120f1a02b4fdbc0776b5d0ad3c04ebcbaa646d586eb899468c,656,46,441,0,1143,Barrow354e279fb5421e120f1a02b4fdbc0776b5d0ad3c04ebcbaa646d586eb899468c
Bartow,354e279fb5421e120f1a02b4fdbc0776b5d0ad3c04ebcbaa646d586eb899468c,788,44,349,2,1183,Bartow354e279fb5421e120f1a02b4fdbc0776b5d0ad3c04ebcbaa646d586eb899468c
Ben Hill,354e279fb5421e120f1a02b4fdbc0776b5d0ad3c04ebcbaa646d586eb899468c,33,11,47,0,91,Ben Hill354e279fb5421e120f1a02b4fdbc0776b5d0ad3c04ebcbaa646d586eb899468c
Berrien,354e279fb5421e120f1a02b4fdbc0776b5d0ad3c04ebcbaa646d586eb899468c,55,13,46,1,115,Berrien354e279fb5421e120f1a02b4fdbc0776b5d0ad3c04ebcbaa646d586eb899468c
Bibb,354e279fb5421e120f1a02b4fdbc0776b5d0ad3c04ebcbaa646d586eb899468c,903,85,452,7,1447,Bibb354e279fb5421e120f1a02b4fdbc0776b5d0ad3c04ebcbaa646d586eb899468c
Bleckley,354e279fb5421e120f1a02b4fdbc0776b5d0ad3c04ebcbaa646d586eb899468c,56,1,66,0,123,Bleckley354e279fb5421e120f1a02b4fdbc0776b5d0ad3c04ebcbaa646d586eb899468c
Brantley,354e279fb5421e120f1a02b4fdbc0776b5d0ad3c04ebcbaa646d586eb899468c,66,5,34,1,106,Brantley354e279fb5421e120f1a02b4fdbc0776b5d0ad3c04ebcbaa646d586eb899468c
Brooks,354e279fb5421e120f1a02b4fdbc0776b5d0ad3c04ebcbaa646d586eb899468c,43,5,37,4,89,Brooks354e279fb5421e120f1a02b4fdbc0776b5d0ad3c04ebcbaa646d586eb899468c
Bryan,354e279fb5421e120f1a02b4fdbc0776b5d0ad3c04ebcbaa646d586eb899468c,256,30,256,0,542,Bryan354e279fb5421e120f1a02b4fdbc0776b5d0ad3c04ebcbaa646d586eb899468c
Bulloch,354e279fb5421e120f1a02b4fdbc0776b5d0ad3c04ebcbaa646d586eb899468c,458,27,405,0,890,Bulloch354e279fb5421e120f1a02b4fdbc0776b5d0ad3c04ebcbaa646d586eb899468c
Burke,354e279fb5421e120f1a02b4fdbc0776b5d0ad3c04ebcbaa646d586eb899468c,76,12,41,0,129,Burke354e279fb5421e120f1a02b4fdbc0776b5d0ad3c04ebcbaa646d586eb899468c
Butts,354e279fb5421e120f1a02b4fdbc0776b5d0ad3c04ebcbaa646d586eb899468c,70,6,118,0,194,Butts354e279fb5421e120f1a02b4fdbc0776b5d0ad3c04ebcbaa646d586eb899468c
Calhoun,354e279fb5421e120f1a02b4fdbc0776b5d0ad3c04ebcbaa646d586eb899468c,13,0,3,0,16,Calhoun354e279fb5421e120f1a02b4fdbc0776b5d0ad3c04ebcbaa646d586eb899468c
Camden,354e279fb5421e120f1a02b4fdbc0776b5d0ad3c04ebcbaa646d586eb899468c,331,48,250,0,629,Camden354e279fb5421e120f1a02b4fdbc0776b5d0ad3c04ebcbaa646d586eb899468c
Candler,354e279fb5421e120f1a02b4fdbc0776b5d0ad3c04ebcbaa646d586eb899468c,35,5,33,0,73,Candler354e279fb5421e120f1a02b4fdbc0776b5d0ad3c04ebcbaa646d586eb899468c
Carroll,354e279fb5421e120f1a02b4fdbc0776b5d0ad3c04ebcbaa646d586eb899468c,741,35,563,7,1346,Carroll354e279fb5421e120f1a02b4fdbc0776b5d0ad3c04ebcbaa646d586eb899468c
Catoosa,354e279fb5421e120f1a02b4fdbc0776b5d0ad3c04ebcbaa646d586eb899468c,461,32,388,0,881,Catoosa354e279fb5421e120f1a02b4fdbc0776b5d0ad3c04ebcbaa646d586eb899468c
Charlton,354e279fb5421e120f1a02b4fdbc0776b5d0ad3c04ebcbaa646d586eb899468c,24,7,23,0,54,Charlton354e279fb5421e120f1a02b4fdbc0776b5d0ad3c04ebcbaa646d586eb899468c
Chatham,354e279fb5421e120f1a02b4fdbc0776b5d0ad3c04ebcbaa646d586eb899468c,2704,125,669,5,3503,Chatham354e279fb5421e120f1a02b4fdbc0776b5d0ad3c04ebcbaa646d586eb899468c
Chattahoochee,354e279fb5421e120f1a02b4fdbc0776b5d0ad3c04ebcbaa646d586eb899468c,27,2,16,0,45,Chattahoochee354e279fb5421e120f1a02b4fdbc0776b5d0ad3c04ebcbaa646d586eb899468c
Chattooga,354e279fb5421e120f1a02b4fdbc0776b5d0ad3c04ebcbaa646d586eb899468c,102,6,69,0,177,Chattooga354e279fb5421e120f1a02b4fdbc0776b5d0ad3c04ebcbaa646d586eb899468c
Cherokee,354e279fb5421e120f1a02b4fdbc0776b5d0ad3c04ebcbaa646d586eb899468c,2772,245,1996,2,5015,Cherokee354e279fb5421e120f1a02b4fdbc0776b5d0ad3c04ebcbaa646d586eb899468c
Clarke,354e279fb5421e120f1a02b4fdbc0776b5d0ad3c04ebcbaa646d586eb899468c,1110,74,832,3,2019,Clarke354e279fb5421e120f1a02b4fdbc0776b5d0ad3c04ebcbaa646d586eb899468c
Clay,354e279fb5421e120f1a02b4fdbc0776b5d0ad3c04ebcbaa646d586eb899468c,6,0,2,0,8,Clay354e279fb5421e120f1a02b4fdbc0776b5d0ad3c04ebcbaa646d586eb899468c
Clayton,354e279fb5421e120f1a02b4fdbc0776b5d0ad3c04ebcbaa646d586eb899468c,794,54,794,5,1647,Clayton354e279fb5421e120f1a02b4fdbc0776b5d0ad3c04ebcbaa646d586eb899468c
Clinch,354e279fb5421e120f1a02b4fdbc0776b5d0ad3c04ebcbaa646d586eb899468c,16,3,15,0,34,Clinch354e279fb5421e120f1a02b4fdbc0776b5d0ad3c04ebcbaa646d586eb899468c
Cobb,354e279fb5421e120f1a02b4fdbc0776b5d0ad3c04ebcbaa646d586eb899468c,9802,934,3693,37,14466,Cobb354e279fb5421e120f1a02b4fdbc0776b5d0ad3c04ebcbaa646d586eb899468c
Coffee,354e279fb5421e120f1a02b4fdbc0776b5d0ad3c04ebcbaa646d586eb899468c,90,17,126,0,233,Coffee354e279fb5421e120f1a02b4fdbc0776b5d0ad3c04ebcbaa646d586eb899468c
Colquitt,354e279fb5421e120f1a02b4fdbc0776b5d0ad3c04ebcbaa646d586eb899468c,127,12,101,0,240,Colquitt354e279fb5421e120f1a02b4fdbc0776b5d0ad3c04ebcbaa646d586eb899468c
Columbia,354e279fb5421e120f1a02b4fdbc0776b5d0ad3c04ebcbaa646d586eb899468c,1285,132,852,1,2270,Columbia354e279fb5421e120f1a02b4fdbc0776b5d0ad3c04ebcbaa646d586eb899468c
Cook,354e279fb5421e120f1a02b4fdbc0776b5d0ad3c04ebcbaa646d586eb899468c,46,6,60,0,112,Cook354e279fb5421e120f1a02b4fdbc0776b5d0ad3c04ebcbaa646d586eb899468c
Coweta,354e279fb5421e120f1a02b4fdbc0776b5d0ad3c04ebcbaa646d586eb899468c,1257,117,858,3,2235,Coweta354e279fb5421e120f1a02b4fdbc0776b5d0ad3c04ebcbaa646d586eb899468c
Crawford,354e279fb5421e120f1a02b4fdbc0776b5d0ad3c04ebcbaa646d586eb899468c,54,4,48,0,106,Crawford354e279fb5421e120f1a02b4fdbc0776b5d0ad3c04ebcbaa646d586eb899468c
Crisp,354e279fb5421e120f1a02b4fdbc0776b5d0ad3c04ebcbaa646d586eb899468c,52,10,64,0,126,Crisp354e279fb5421e120f1a02b4fdbc0776b5d0ad3c04ebcbaa646d586eb899468c
Dade,354e279fb5421e120f1a02b4fdbc0776b5d0ad3c04ebcbaa646d586eb899468c,145,7,74,0,226,Dade354e279fb5421e120f1a02b4fdbc0776b5d0ad3c04ebcbaa646d586eb899468c
Dawson,354e279fb5421e120f1a02b4fdbc0776b5d0ad3c04ebcbaa646d586eb899468c,157,14,185,0,356,Dawson354e279fb5421e120f1a02b4fdbc0776b5d0ad3c04ebcbaa646d586eb899468c
Decatur,354e279fb5421e120f1a02b4fdbc0776b5d0ad3c04ebcbaa646d586eb899468c,64,8,53,1,126,Decatur354e279fb5421e120f1a02b4fdbc0776b5d0ad3c04ebcbaa646d586eb899468c
DeKalb,354e279fb5421e120f1a02b4fdbc0776b5d0ad3c04ebcbaa646d586eb899468c,5335,438,3875,18,9666,DeKalb354e279fb5421e120f1a02b4fdbc0776b5d0ad3c04ebcbaa646d586eb899468c
Dodge,354e279fb5421e120f1a02b4fdbc0776b5d0ad3c04ebcbaa646d586eb899468c,74,9,55,0,138,Dodge354e279fb5421e120f1a02b4fdbc0776b5d0ad3c04ebcbaa646d586eb899468c
Dooly,354e279fb5421e120f1a02b4fdbc0776b5d0ad3c04ebcbaa646d586eb899468c,19,4,12,1,36,Dooly354e279fb5421e120f1a02b4fdbc0776b5d0ad3c04ebcbaa646d586eb899468c
Dougherty,354e279fb5421e120f1a02b4fdbc0776b5d0ad3c04ebcbaa646d586eb899468c,306,31,137,1,475,Dougherty354e279fb5421e120f1a02b4fdbc0776b5d0ad3c04ebcbaa646d586eb899468c
Douglas,354e279fb5421e120f1a02b4fdbc0776b5d0ad3c04ebcbaa646d586eb899468c,737,63,794,0,1594,Douglas354e279fb5421e120f1a02b4fdbc0776b5d0ad3c04ebcbaa646d586eb899468c
Early,354e279fb5421e120f1a02b4fdbc0776b5d0ad3c04ebcbaa646d586eb899468c,34,7,24,0,65,Early354e279fb5421e120f1a02b4fdbc0776b5d0ad3c04ebcbaa646d586eb899468c
Echols,354e279fb5421e120f1a02b4fdbc0776b5d0ad3c04ebcbaa646d586eb899468c,6,1,6,0,13,Echols354e279fb5421e120f1a02b4fdbc0776b5d0ad3c04ebcbaa646d586eb899468c
Effingham,354e279fb5421e120f1a02b4fdbc0776b5d0ad3c04ebcbaa646d586eb899468c,399,24,256,0,679,Effingham354e279fb5421e120f1a02b4fdbc0776b5d0ad3c04ebcbaa646d586eb899468c
Elbert,354e279fb5421e120f1a02b4fdbc0776b5d0ad3c04ebcbaa646d586eb899468c,62,13,61,3,139,Elbert354e279fb5421e120f1a02b4fdbc0776b5d0ad3c04ebcbaa646d586eb899468c
Emanuel,354e279fb5421e120f1a02b4fdbc0776b5d0ad3c04ebcbaa646d586eb899468c,40,4,31,0,75,Emanuel354e279fb5421e120f1a02b4fdbc0776b5d0ad3c04ebcbaa646d586eb899468c
Evans,354e279fb5421e120f1a02b4fdbc0776b5d0ad3c04ebcbaa646d586eb899468c,26,3,39,0,68,Evans354e279fb5421e120f1a02b4fdbc0776b5d0ad3c04ebcbaa646d586eb899468c
Fannin,354e279fb5421e120f1a02b4fdbc0776b5d0ad3c04ebcbaa646d586eb899468c,107,20,95,0,222,Fannin354e279fb5421e120f1a02b4fdbc0776b5d0ad3c04ebcbaa646d586eb899468c
Fayette,354e279fb5421e120f1a02b4fdbc0776b5d0ad3c04ebcbaa646d586eb899468c,965,134,1004,0,2103,Fayette354e279fb5421e120f1a02b4fdbc0776b5d0ad3c04ebcbaa646d586eb899468c
Floyd,354e279fb5421e120f1a02b4fdbc0776b5d0ad3c04ebcbaa646d586eb899468c,539,54,485,6,1084,Floyd354e279fb5421e120f1a02b4fdbc0776b5d0ad3c04ebcbaa646d586eb899468c
Forsyth,354e279fb5421e120f1a02b4fdbc0776b5d0ad3c04ebcbaa646d586eb899468c,1528,191,2369,3,4091,Forsyth354e279fb5421e120f1a02b4fdbc0776b5d0ad3c04ebcbaa646d586eb899468c
Franklin,354e279fb5421e120f1a02b4fdbc0776b5d0ad3c04ebcbaa646d586eb899468c,110,11,56,0,177,Franklin354e279fb5421e120f1a02b4fdbc0776b5d0ad3c04ebcbaa646d586eb899468c
Fulton,354e279fb5421e120f1a02b4fdbc0776b5d0ad3c04ebcbaa646d586eb899468c,7605,783,7332,45,15765,Fulton354e279fb5421e120f1a02b4fdbc0776b5d0ad3c04ebcbaa646d586eb899468c
Gilmer,354e279fb5421e120f1a02b4fdbc0776b5d0ad3c04ebcbaa646d586eb899468c,140,12,141,0,293,Gilmer354e279fb5421e120f1a02b4fdbc0776b5d0ad3c04ebcbaa646d586eb899468c
Glascock,354e279fb5421e120f1a02b4fdbc0776b5d0ad3c04ebcbaa646d586eb899468c,10,1,6,0,17,Glascock354e279fb5421e120f1a02b4fdbc0776b5d0ad3c04ebcbaa646d586eb899468c
Glynn,354e279fb5421e120f1a02b4fdbc0776b5d0ad3c04ebcbaa646d586eb899468c,469,41,313,2,825,Glynn354e279fb5421e120f1a02b4fdbc0776b5d0ad3c04ebcbaa646d586eb899468c
Gordon,354e279fb5421e120f1a02b4fdbc0776b5d0ad3c04ebcbaa646d586eb899468c,286,19,199,3,507,Gordon354e279fb5421e120f1a02b4fdbc0776b5d0ad3c04ebcbaa646d586eb899468c
Grady,354e279fb5421e120f1a02b4fdbc0776b5d0ad3c04ebcbaa646d586eb899468c,83,8,44,0,135,Grady354e279fb5421e120f1a02b4fdbc0776b5d0ad3c04ebcbaa646d586eb899468c
Greene,354e279fb5421e120f1a02b4fdbc0776b5d0ad3c04ebcbaa646d586eb899468c,52,10,88,1,151,Greene354e279fb5421e120f1a02b4fdbc0776b5d0ad3c04ebcbaa646d586eb899468c
Gwinnett,354e279fb5421e120f1a02b4fdbc0776b5d0ad3c04ebcbaa646d586eb899468c,7904,730,3780,80,12494,Gwinnett354e279fb5421e120f1a02b4fdbc0776b5d0ad3c04ebcbaa646d586eb899468c
Habersham,354e279fb5421e120f1a02b4fdbc0776b5d0ad3c04ebcbaa646d586eb899468c,183,28,250,0,461,Habersham354e279fb5421e120f1a02b4fdbc0776b5d0ad3c04ebcbaa646d586eb899468c
Hall,354e279fb5421e120f1a02b4fdbc0776b5d0ad3c04ebcbaa646d586eb899468c,1380,124,798,5,2307,Hall354e279fb5421e120f1a02b4fdbc0776b5d0ad3c04ebcbaa646d586eb899468c
Hancock,354e279fb5421e120f1a02b4fdbc0776b5d0ad3c04ebcbaa646d586eb899468c,21,2,13,0,36,Hancock354e279fb5421e120f1a02b4fdbc0776b5d0ad3c04ebcbaa646d586eb899468c
Haralson,354e279fb5421e120f1a02b4fdbc0776b5d0ad3c04ebcbaa646d586eb899468c,151,12,101,0,264,Haralson354e279fb5421e120f1a02b4fdbc0776b5d0ad3c04ebcbaa646d586eb899468c
Harris,354e279fb5421e120f1a02b4fdbc0776b5d0ad3c04ebcbaa646d586eb899468c,200,23,156,0,379,Harris354e279fb5421e120f1a02b4fdbc0776b5d0ad3c04ebcbaa646d586eb899468c
Hart,354e279fb5421e120f1a02b4fdbc0776b5d0ad3c04ebcbaa646d586eb899468c,106,10,93,0,209,Hart354e279fb5421e120f1a02b4fdbc0776b5d0ad3c04ebcbaa646d586eb899468c
Heard,354e279fb5421e120f1a02b4fdbc0776b5d0ad3c04ebcbaa646d586eb899468c,60,6,27,0,93,Heard354e279fb5421e120f1a02b4fdbc0776b5d0ad3c04ebcbaa646d586eb899468c
Henry,354e279fb5421e120f1a02b4fdbc0776b5d0ad3c04ebcbaa646d586eb899468c,1026,106,1364,9,2505,Henry354e279fb5421e120f1a02b4fdbc0776b5d0ad3c04ebcbaa646d586eb899468c
Houston,354e279fb5421e120f1a02b4fdbc0776b5d0ad3c04ebcbaa646d586eb899468c,791,99,861,10,1761,Houston354e279fb5421e120f1a02b4fdbc0776b5d0ad3c04ebcbaa646d586eb899468c
Irwin,354e279fb5421e120f1a02b4fdbc0776b5d0ad3c04ebcbaa646d586eb899468c,26,3,29,0,58,Irwin354e279fb5421e120f1a02b4fdbc0776b5d0ad3c04ebcbaa646d586eb899468c
Jackson,354e279fb5421e120f1a02b4fdbc0776b5d0ad3c04ebcbaa646d586eb899468c,402,27,405,0,834,Jackson354e279fb5421e120f1a02b4fdbc0776b5d0ad3c04ebcbaa646d586eb899468c
Jasper,354e279fb5421e120f1a02b4fdbc0776b5d0ad3c04ebcbaa646d586eb899468c,59,8,52,0,119,Jasper354e279fb5421e120f1a02b4fdbc0776b5d0ad3c04ebcbaa646d586eb899468c
Jeff Davis,354e279fb5421e120f1a02b4fdbc0776b5d0ad3c04ebcbaa646d586eb899468c,48,5,33,0,86,Jeff Davis354e279fb5421e120f1a02b4fdbc0776b5d0ad3c04ebcbaa646d586eb899468c
Jefferson,354e279fb5421e120f1a02b4fdbc0776b5d0ad3c04ebcbaa646d586eb899468c,40,5,24,1,70,Jefferson354e279fb5421e120f1a02b4fdbc0776b5d0ad3c04ebcbaa646d586eb899468c
Jenkins,354e279fb5421e120f1a02b4fdbc0776b5d0ad3c04ebcbaa646d586eb899468c,12,2,20,0,34,Jenkins354e279fb5421e120f1a02b4fdbc0776b5d0ad3c04ebcbaa646d586eb899468c
Johnson,354e279fb5421e120f1a02b4fdbc0776b5d0ad3c04ebcbaa646d586eb899468c,19,2,6,0,27,Johnson354e279fb5421e120f1a02b4fdbc0776b5d0ad3c04ebcbaa646d586eb899468c
Jones,354e279fb5421e120f1a02b4fdbc0776b5d0ad3c04ebcbaa646d586eb899468c,116,16,128,0,260,Jones354e279fb5421e120f1a02b4fdbc0776b5d0ad3c04ebcbaa646d586eb899468c
Lamar,354e279fb5421e120f1a02b4fdbc0776b5d0ad3c04ebcbaa646d586eb899468c,66,5,54,1,126,Lamar354e279fb5421e120f1a02b4fdbc0776b5d0ad3c04ebcbaa646d586eb899468c
Lanier,354e279fb5421e120f1a02b4fdbc0776b5d0ad3c04ebcbaa646d586eb899468c,40,3,29,1,73,Lanier354e279fb5421e120f1a02b4fdbc0776b5d0ad3c04ebcbaa646d586eb899468c
Laurens,354e279fb5421e120f1a02b4fdbc0776b5d0ad3c04ebcbaa646d586eb899468c,171,26,116,0,313,Laurens354e279fb5421e120f1a02b4fdbc0776b5d0ad3c04ebcbaa646d586eb899468c
Lee,354e279fb5421e120f1a02b4fdbc0776b5d0ad3c04ebcbaa646d586eb899468c,161,20,118,0,299,Lee354e279fb5421e120f1a02b4fdbc0776b5d0ad3c04ebcbaa646d586eb899468c
Liberty,354e279fb5421e120f1a02b4fdbc0776b5d0ad3c04ebcbaa646d586eb899468c,244,11,171,1,427,Liberty354e279fb5421e120f1a02b4fdbc0776b5d0ad3c04ebcbaa646d586eb899468c
Lincoln,354e279fb5421e120f1a02b4fdbc0776b5d0ad3c04ebcbaa646d586eb899468c,33,4,33,0,70,Lincoln354e279fb5421e120f1a02b4fdbc0776b5d0ad3c04ebcbaa646d586eb899468c
Long,354e279fb5421e120f1a02b4fdbc0776b5d0ad3c04ebcbaa646d586eb899468c,74,2,54,1,131,Long354e279fb5421e120f1a02b4fdbc0776b5d0ad3c04ebcbaa646d586eb899468c
Lowndes,354e279fb5421e120f1a02b4fdbc0776b5d0ad3c04ebcbaa646d586eb899468c,379,53,479,18,929,Lowndes354e279fb5421e120f1a02b4fdbc0776b5d0ad3c04ebcbaa646d586eb899468c
Lumpkin,354e279fb5421e120f1a02b4fdbc0776b5d0ad3c04ebcbaa646d586eb899468c,185,18,292,0,495,Lumpkin354e279fb5421e120f1a02b4fdbc0776b5d0ad3c04ebcbaa646d586eb899468c
Macon,354e279fb5421e120f1a02b4fdbc0776b5d0ad3c04ebcbaa646d586eb899468c,24,4,14,0,42,Macon354e279fb5421e120f1a02b4fdbc0776b5d0ad3c04ebcbaa646d586eb899468c
Madison,354e279fb5421e120f1a02b4fdbc0776b5d0ad3c04ebcbaa646d586eb899468c,187,17,123,1,328,Madison354e279fb5421e120f1a02b4fdbc0776b5d0ad3c04ebcbaa646d586eb899468c
Marion,354e279fb5421e120f1a02b4fdbc0776b5d0ad3c04ebcbaa646d586eb899468c,22,3,24,0,49,Marion354e279fb5421e120f1a02b4fdbc0776b5d0ad3c04ebcbaa646d586eb899468c
McDuffie,354e279fb5421e120f1a02b4fdbc0776b5d0ad3c04ebcbaa646d586eb899468c,55,13,69,0,137,McDuffie354e279fb5421e120f1a02b4fdbc0776b5d0ad3c04ebcbaa646d586eb899468c
McIntosh,354e279fb5421e120f1a02b4fdbc0776b5d0ad3c04ebcbaa646d586eb899468c,57,12,44,0,113,McIntosh354e279fb5421e120f1a02b4fdbc0776b5d0ad3c04ebcbaa646d586eb899468c
Meriwether,354e279fb5421e120f1a02b4fdbc0776b5d0ad3c04ebcbaa646d586eb899468c,104,8,53,0,165,Meriwether354e279fb5421e120f1a02b4fdbc0776b5d0ad3c04ebcbaa646d586eb899468c
Miller,354e279fb5421e120f1a02b4fdbc0776b5d0ad3c04ebcbaa646d586eb899468c,19,3,8,0,30,Miller354e279fb5421e120f1a02b4fdbc0776b5d0ad3c04ebcbaa646d586eb899468c
Mitchell,354e279fb5421e120f1a02b4fdbc0776b5d0ad3c04ebcbaa646d586eb899468c,53,7,33,0,93,Mitchell354e279fb5421e120f1a02b4fdbc0776b5d0ad3c04ebcbaa646d586eb899468c
Monroe,354e279fb5421e120f1a02b4fdbc0776b5d0ad3c04ebcbaa646d586eb899468c,171,11,102,0,284,Monroe354e279fb5421e120f1a02b4fdbc0776b5d0ad3c04ebcbaa646d586eb899468c
Montgomery,354e279fb5421e120f1a02b4fdbc0776b5d0ad3c04ebcbaa646d586eb899468c,27,2,16,0,45,Montgomery354e279fb5421e120f1a02b4fdbc0776b5d0ad3c04ebcbaa646d586eb899468c
Morgan,354e279fb5421e120f1a02b4fdbc0776b5d0ad3c04ebcbaa646d586eb899468c,104,11,103,0,218,Morgan354e279fb5421e120f1a02b4fdbc0776b5d0ad3c04ebcbaa646d586eb899468c
Murray,354e279fb5421e120f1a02b4fdbc0776b5d0ad3c04ebcbaa646d586eb899468c,180,16,87,0,283,Murray354e279fb5421e120f1a02b4fdbc0776b5d0ad3c04ebcbaa646d586eb899468c
Muscogee,354e279fb5421e120f1a02b4fdbc0776b5d0ad3c04ebcbaa646d586eb899468c,1057,109,661,4,1831,Muscogee354e279fb5421e120f1a02b4fdbc0776b5d0ad3c04ebcbaa646d586eb899468c
Newton,354e279fb5421e120f1a02b4fdbc0776b5d0ad3c04ebcbaa646d586eb899468c,590,45,311,1,947,Newton354e279fb5421e120f1a02b4fdbc0776b5d0ad3c04ebcbaa646d586eb899468c
Oconee,354e279fb5421e120f1a02b4fdbc0776b5d0ad3c04ebcbaa646d586eb899468c,480,32,412,1,925,Oconee354e279fb5421e120f1a02b4fdbc0776b5d0ad3c04ebcbaa646d586eb899468c
Oglethorpe,354e279fb5421e120f1a02b4fdbc0776b5d0ad3c04ebcbaa646d586eb899468c,103,11,85,0,199,Oglethorpe354e279fb5421e120f1a02b4fdbc0776b5d0ad3c04ebcbaa646d586eb899468c
Paulding,354e279fb5421e120f1a02b4fdbc0776b5d0ad3c04ebcbaa646d586eb899468c,890,88,974,2,1954,Paulding354e279fb5421e120f1a02b4fdbc0776b5d0ad3c04ebcbaa646d586eb899468c
Peach,354e279fb5421e120f1a02b4fdbc0776b5d0ad3c04ebcbaa646d586eb899468c,98,8,105,0,211,Peach354e279fb5421e120f1a02b4fdbc0776b5d0ad3c04ebcbaa646d586eb899468c
Pickens,354e279fb5421e120f1a02b4fdbc0776b5d0ad3c04ebcbaa646d586eb899468c,185,10,159,0,354,Pickens354e279fb5421e120f1a02b4fdbc0776b5d0ad3c04ebcbaa646d586eb899468c
Pierce,354e279fb5421e120f1a02b4fdbc0776b5d0ad3c04ebcbaa646d586eb899468c,37,8,48,0,93,Pierce354e279fb5421e120f1a02b4fdbc0776b5d0ad3c04ebcbaa646d586eb899468c
Pike,354e279fb5421e120f1a02b4fdbc0776b5d0ad3c04ebcbaa646d586eb899468c,84,10,69,0,163,Pike354e279fb5421e120f1a02b4fdbc0776b5d0ad3c04ebcbaa646d586eb899468c
Polk,354e279fb5421e120f1a02b4fdbc0776b5d0ad3c04ebcbaa646d586eb899468c,137,18,134,0,289,Polk354e279fb5421e120f1a02b4fdbc0776b5d0ad3c04ebcbaa646d586eb899468c
Pulaski,354e279fb5421e120f1a02b4fdbc0776b5d0ad3c04ebcbaa646d586eb899468c,15,3,40,0,58,Pulaski354e279fb5421e120f1a02b4fdbc0776b5d0ad3c04ebcbaa646d586eb899468c
Putnam,354e279fb5421e120f1a02b4fdbc0776b5d0ad3c04ebcbaa646d586eb899468c,91,10,69,0,170,Putnam354e279fb5421e120f1a02b4fdbc0776b5d0ad3c04ebcbaa646d586eb899468c
Quitman,354e279fb5421e120f1a02b4fdbc0776b5d0ad3c04ebcbaa646d586eb899468c,3,0,5,0,8,Quitman354e279fb5421e120f1a02b4fdbc0776b5d0ad3c04ebcbaa646d586eb899468c
Rabun,354e279fb5421e120f1a02b4fdbc0776b5d0ad3c04ebcbaa646d586eb899468c,64,23,132,0,219,Rabun354e279fb5421e120f1a02b4fdbc0776b5d0ad3c04ebcbaa646d586eb899468c
Randolph,354e279fb5421e120f1a02b4fdbc0776b5d0ad3c04ebcbaa646d586eb899468c,17,3,8,0,28,Randolph354e279fb5421e120f1a02b4fdbc0776b5d0ad3c04ebcbaa646d586eb899468c
Richmond,354e279fb5421e120f1a02b4fdbc0776b5d0ad3c04ebcbaa646d586eb899468c,1099,105,603,4,1811,Richmond354e279fb5421e120f1a02b4fdbc0776b5d0ad3c04ebcbaa646d586eb899468c
Rockdale,354e279fb5421e120f1a02b4fdbc0776b5d0ad3c04ebcbaa646d586eb899468c,396,41,485,1,923,Rockdale354e279fb5421e120f1a02b4fdbc0776b5d0ad3c04ebcbaa646d586eb899468c
Schley,354e279fb5421e120f1a02b4fdbc0776b5d0ad3c04ebcbaa646d586eb899468c,20,3,13,0,36,Schley354e279fb5421e120f1a02b4fdbc0776b5d0ad3c04ebcbaa646d586eb899468c
Screven,354e279fb5421e120f1a02b4fdbc0776b5d0ad3c04ebcbaa646d586eb899468c,41,7,46,0,94,Screven354e279fb5421e120f1a02b4fdbc0776b5d0ad3c04ebcbaa646d586eb899468c
Seminole,354e279fb5421e120f1a02b4fdbc0776b5d0ad3c04ebcbaa646d586eb899468c,35,3,10,0,48,Seminole354e279fb5421e120f1a02b4fdbc0776b5d0ad3c04ebcbaa646d586eb899468c
Spalding,354e279fb5421e120f1a02b4fdbc0776b5d0ad3c04ebcbaa646d586eb899468c,301,27,269,0,597,Spalding354e279fb5421e120f1a02b4fdbc0776b5d0ad3c04ebcbaa646d586eb899468c
Stephens,354e279fb5421e120f1a02b4fdbc0776b5d0ad3c04ebcbaa646d586eb899468c,86,14,143,0,243,Stephens354e279fb5421e120f1a02b4fdbc0776b5d0ad3c04ebcbaa646d586eb899468c
Stewart,354e279fb5421e120f1a02b4fdbc0776b5d0ad3c04ebcbaa646d586eb899468c,9,7,12,0,28,Stewart354e279fb5421e120f1a02b4fdbc0776b5d0ad3c04ebcbaa646d586eb899468c
Sumter,354e279fb5421e120f1a02b4fdbc0776b5d0ad3c04ebcbaa646d586eb899468c,96,10,72,0,178,Sumter354e279fb5421e120f1a02b4fdbc0776b5d0ad3c04ebcbaa646d586eb899468c
Talbot,354e279fb5421e120f1a02b4fdbc0776b5d0ad3c04ebcbaa646d586eb899468c,25,11,10,0,46,Talbot354e279fb5421e120f1a02b4fdbc0776b5d0ad3c04ebcbaa646d586eb899468c
Taliaferro,354e279fb5421e120f1a02b4fdbc0776b5d0ad3c04ebcbaa646d586eb899468c,0,0,3,0,3,Taliaferro354e279fb5421e120f1a02b4fdbc0776b5d0ad3c04ebcbaa646d586eb899468c
Tattnall,354e279fb5421e120f1a02b4fdbc0776b5d0ad3c04ebcbaa646d586eb899468c,46,16,47,0,109,Tattnall354e279fb5421e120f1a02b4fdbc0776b5d0ad3c04ebcbaa646d586eb899468c
Taylor,354e279fb5421e120f1a02b4fdbc0776b5d0ad3c04ebcbaa646d586eb899468c,18,4,23,0,45,Taylor354e279fb5421e120f1a02b4fdbc0776b5d0ad3c04ebcbaa646d586eb899468c
Telfair,354e279fb5421e120f1a02b4fdbc0776b5d0ad3c04ebcbaa646d586eb899468c,20,3,9,0,32,Telfair354e279fb5421e120f1a02b4fdbc0776b5d0ad3c04ebcbaa646d586eb899468c
Terrell,354e279fb5421e120f1a02b4fdbc0776b5d0ad3c04ebcbaa646d586eb899468c,28,2,10,0,40,Terrell354e279fb5421e120f1a02b4fdbc0776b5d0ad3c04ebcbaa646d586eb899468c
Thomas,354e279fb5421e120f1a02b4fdbc0776b5d0ad3c04ebcbaa646d586eb899468c,167,23,177,1,368,Thomas354e279fb5421e120f1a02b4fdbc0776b5d0ad3c04ebcbaa646d586eb899468c
Tift,354e279fb5421e120f1a02b4fdbc0776b5d0ad3c04ebcbaa646d586eb899468c,131,11,102,0,244,Tift354e279fb5421e120f1a02b4fdbc0776b5d0ad3c04ebcbaa646d586eb899468c
Toombs,354e279fb5421e120f1a02b4fdbc0776b5d0ad3c04ebcbaa646d586eb899468c,87,17,54,0,158,Toombs354e279fb5421e120f1a02b4fdbc0776b5d0ad3c04ebcbaa646d586eb899468c
Towns,354e279fb5421e120f1a02b4fdbc0776b5d0ad3c04ebcbaa646d586eb899468c,58,10,76,2,146,Towns354e279fb5421e120f1a02b4fdbc0776b5d0ad3c04ebcbaa646d586eb899468c
Treutlen,354e279fb5421e120f1a02b4fdbc0776b5d0ad3c04ebcbaa646d586eb899468c,16,2,14,0,32,Treutlen354e279fb5421e120f1a02b4fdbc0776b5d0ad3c04ebcbaa646d586eb899468c
Troup,354e279fb5421e120f1a02b4fdbc0776b5d0ad3c04ebcbaa646d586eb899468c,305,33,215,8,561,Troup354e279fb5421e120f1a02b4fdbc0776b5d0ad3c04ebcbaa646d586eb899468c
Turner,354e279fb5421e120f1a02b4fdbc0776b5d0ad3c04ebcbaa646d586eb899468c,17,2,34,0,53,Turner354e279fb5421e120f1a02b4fdbc0776b5d0ad3c04ebcbaa646d586eb899468c
Twiggs,354e279fb5421e120f1a02b4fdbc0776b5d0ad3c04ebcbaa646d586eb899468c,32,4,14,0,50,Twiggs354e279fb5421e120f1a02b4fdbc0776b5d0ad3c04ebcbaa646d586eb899468c
Union,354e279fb5421e120f1a02b4fdbc0776b5d0ad3c04ebcbaa646d586eb899468c,98,14,116,1,229,Union354e279fb5421e120f1a02b4fdbc0776b5d0ad3c04ebcbaa646d586eb899468c
Upson,354e279fb5421e120f1a02b4fdbc0776b5d0ad3c04ebcbaa646d586eb899468c,71,10,86,0,167,Upson354e279fb5421e120f1a02b4fdbc0776b5d0ad3c04ebcbaa646d586eb899468c
Walker,354e279fb5421e120f1a02b4fdbc0776b5d0ad3c04ebcbaa646d586eb899468c,409,36,343,3,791,Walker354e279fb5421e120f1a02b4fdbc0776b5d0ad3c04ebcbaa646d586eb899468c
Walton,354e279fb5421e120f1a02b4fdbc0776b5d0ad3c04ebcbaa646d586eb899468c,644,62,347,2,1055,Walton354e279fb5421e120f1a02b4fdbc0776b5d0ad3c04ebcbaa646d586eb899468c
Ware,354e279fb5421e120f1a02b4fdbc0776b5d0ad3c04ebcbaa646d586eb899468c,110,13,83,0,206,Ware354e279fb5421e120f1a02b4fdbc0776b5d0ad3c04ebcbaa646d586eb899468c
Warren,354e279fb5421e120f1a02b4fdbc0776b5d0ad3c04ebcbaa646d586eb899468c,10,2,16,0,28,Warren354e279fb5421e120f1a02b4fdbc0776b5d0ad3c04ebcbaa646d586eb899468c
Washington,354e279fb5421e120f1a02b4fdbc0776b5d0ad3c04ebcbaa646d586eb899468c,43,12,42,1,98,Washington354e279fb5421e120f1a02b4fdbc0776b5d0ad3c04ebcbaa646d586eb899468c
Wayne,354e279fb5421e120f1a02b4fdbc0776b5d0ad3c04ebcbaa646d586eb899468c,107,8,75,2,192,Wayne354e279fb5421e120f1a02b4fdbc0776b5d0ad3c04ebcbaa646d586eb899468c
Webster,354e279fb5421e120f1a02b4fdbc0776b5d0ad3c04ebcbaa646d586eb899468c,6,0,7,0,13,Webster354e279fb5421e120f1a02b4fdbc0776b5d0ad3c04ebcbaa646d586eb899468c
Wheeler,354e279fb5421e120f1a02b4fdbc0776b5d0ad3c04ebcbaa646d586eb899468c,12,3,19,1,35,Wheeler354e279fb5421e120f1a02b4fdbc0776b5d0ad3c04ebcbaa646d586eb899468c
White,354e279fb5421e120f1a02b4fdbc0776b5d0ad3c04ebcbaa646d586eb899468c,191,14,143,0,348,White354e279fb5421e120f1a02b4fdbc0776b5d0ad3c04ebcbaa646d586eb899468c
Whitfield,354e279fb5421e120f1a02b4fdbc0776b5d0ad3c04ebcbaa646d586eb899468c,602,40,281,1,924,Whitfield354e279fb5421e120f1a02b4fdbc0776b5d0ad3c04ebcbaa646d586eb899468c
Wilcox,354e279fb5421e120f1a02b4fdbc0776b5d0ad3c04ebcbaa646d586eb899468c,15,3,7,0,25,Wilcox354e279fb5421e120f1a02b4fdbc0776b5d0ad3c04ebcbaa646d586eb899468c
Wilkes,354e279fb5421e120f1a02b4fdbc0776b5d0ad3c04ebcbaa646d586eb899468c,34,1,22,0,57,Wilkes354e279fb5421e120f1a02b4fdbc0776b5d0ad3c04ebcbaa646d586eb899468c
Wilkinson,354e279fb5421e120f1a02b4fdbc0776b5d0ad3c04ebcbaa646d586eb899468c,35,3,13,0,51,Wilkinson354e279fb5421e120f1a02b4fdbc0776b5d0ad3c04ebcbaa646d586eb899468c
Worth,354e279fb5421e120f1a02b4fdbc0776b5d0ad3c04ebcbaa646d586eb899468c,54,11,42,1,108,Worth354e279fb5421e120f1a02b4fdbc0776b5d0ad3c04ebcbaa646d586eb899468c
Appling,fdb13ab7505be16a2ad25cb94d9a448bbdf35511ddcbc7405d15e2f9bcf8b8f2,2793,360,2015,2,5170,Applingfdb13ab7505be16a2ad25cb94d9a448bbdf35511ddcbc7405d15e2f9bcf8b8f2
Atkinson,fdb13ab7505be16a2ad25cb94d9a448bbdf35511ddcbc7405d15e2f9bcf8b8f2,738,61,874,5,1678,Atkinsonfdb13ab7505be16a2ad25cb94d9a448bbdf35511ddcbc7405d15e2f9bcf8b8f2
Bacon,fdb13ab7505be16a2ad25cb94d9a448bbdf35511ddcbc7405d15e2f9bcf8b8f2,1033,129,1880,4,3046,Baconfdb13ab7505be16a2ad25cb94d9a448bbdf35511ddcbc7405d15e2f9bcf8b8f2
Baker,fdb13ab7505be16a2ad25cb94d9a448bbdf35511ddcbc7405d15e2f9bcf8b8f2,388,75,299,1,763,Bakerfdb13ab7505be16a2ad25cb94d9a448bbdf35511ddcbc7405d15e2f9bcf8b8f2
Baldwin,fdb13ab7505be16a2ad25cb94d9a448bbdf35511ddcbc7405d15e2f9bcf8b8f2,2924,364,4506,2,7796,Baldwinfdb13ab7505be16a2ad25cb94d9a448bbdf35511ddcbc7405d15e2f9bcf8b8f2
Banks,fdb13ab7505be16a2ad25cb94d9a448bbdf35511ddcbc7405d15e2f9bcf8b8f2,2819,182,2703,1,5705,Banksfdb13ab7505be16a2ad25cb94d9a448bbdf35511ddcbc7405d15e2f9bcf8b8f2
Barrow,fdb13ab7505be16a2ad25cb94d9a448bbdf35511ddcbc7405d15e2f9bcf8b8f2,8546,770,10965,0,20281,Barrowfdb13ab7505be16a2ad25cb94d9a448bbdf35511ddcbc7405d15e2f9bcf8b8f2
Bartow,fdb13ab7505be16a2ad25cb94d9a448bbdf35511ddcbc7405d15e2f9bcf8b8f2,14515,1066,12474,18,28073,Bartowfdb13ab7505be16a2ad25cb94d9a448bbdf35511ddcbc7405d15e2f9bcf8b8f2
Ben Hill,fdb13ab7505be16a2ad25cb94d9a448bbdf35511ddcbc7405d15e2f9bcf8b8f2,873,122,2589,5,3589,Ben Hillfdb13ab7505be16a2ad25cb94d9a448bbdf35511ddcbc7405d15e2f9bcf8b8f2
Berrien,fdb13ab7505be16a2ad25cb94d9a448bbdf35511ddcbc7405d15e2f9bcf8b8f2,2203,276,2568,14,5061,Berrienfdb13ab7505be16a2ad25cb94d9a448bbdf35511ddcbc7405d15e2f9bcf8b8f2
Bibb,fdb13ab7505be16a2ad25cb94d9a448bbdf35511ddcbc7405d15e2f9bcf8b8f2,13342,1600,10612,47,25601,Bibbfdb13ab7505be16a2ad25cb94d9a448bbdf35511ddcbc7405d15e2f9bcf8b8f2
Bleckley,fdb13ab7505be16a2ad25cb94d9a448bbdf35511ddcbc7405d15e2f9bcf8b8f2,1518,133,2045,2,3698,Bleckleyfdb13ab7505be16a2ad25cb94d9a448bbdf35511ddcbc7405d15e2f9bcf8b8f2
Brantley,fdb13ab7505be16a2ad25cb94d9a448bbdf35511ddcbc7405d15e2f9bcf8b8f2,2160,188,2491,5,4844,Brantleyfdb13ab7505be16a2ad25cb94d9a448bbdf35511ddcbc7405d15e2f9bcf8b8f2
Brooks,fdb13ab7505be16a2ad25cb94d9a448bbdf35511ddcbc7405d15e2f9bcf8b8f2,1634,174,1637,20,3465,Brooksfdb13ab7505be16a2ad25cb94d9a448bbdf35511ddcbc7405d15e2f9bcf8b8f2
Bryan,fdb13ab7505be16a2ad25cb94d9a448bbdf35511ddcbc7405d15e2f9bcf8b8f2,3887,310,6284,7,10488,Bryanfdb13ab7505be16a2ad25cb94d9a448bbdf35511ddcbc7405d15e2f9bcf8b8f2
Bulloch,fdb13ab7505be16a2ad25cb94d9a448bbdf35511ddcbc7405d15e2f9bcf8b8f2,7496,627,7374,33,15530,Bullochfdb13ab7505be16a2ad25cb94d9a448bbdf35511ddcbc7405d15e2f9bcf8b8f2
Burke,fdb13ab7505be16a2ad25cb94d9a448bbdf35511ddcbc7405d15e2f9bcf8b8f2,2206,278,1964,0,4448,Burkefdb13ab7505be16a2ad25cb94d9a448bbdf35511ddcbc7405d15e2f9bcf8b8f2
Butts,fdb13ab7505be16a2ad25cb94d9a448bbdf35511ddcbc7405d15e2f9bcf8b8f2,1653,195,4472,0,6320,Buttsfdb13ab7505be16a2ad25cb94d9a448bbdf35511ddcbc7405d15e2f9bcf8b8f2
Calhoun,fdb13ab7505be16a2ad25cb94d9a448bbdf35511ddcbc7405d15e2f9bcf8b8f2,469,48,345,0,862,Calhounfdb13ab7505be16a2ad25cb94d9a448bbdf35511ddcbc7405d15e2f9bcf8b8f2
Camden,fdb13ab7505be16a2ad25cb94d9a448bbdf35511ddcbc7405d15e2f9bcf8b8f2,4420,634,6388,12,11454,Camdenfdb13ab7505be16a2ad25cb94d9a448bbdf35511ddcbc7405d15e2f9bcf8b8f2
Candler,fdb13ab7505be16a2ad25cb94d9a448bbdf35511ddcbc7405d15e2f9bcf8b8f2,580,88,1917,3,2588,Candlerfdb13ab7505be16a2ad25cb94d9a448bbdf35511ddcbc7405d15e2f9bcf8b8f2
Carroll,fdb13ab7505be16a2ad25cb94d9a448bbdf35511ddcbc7405d15e2f9bcf8b8f2,12468,905,15622,48,29043,Carrollfdb13ab7505be16a2ad25cb94d9a448bbdf35511ddcbc7405d15e2f9bcf8b8f2
Catoosa,fdb13ab7505be16a2ad25cb94d9a448bbdf35511ddcbc7405d15e2f9bcf8b8f2,6201,472,12201,14,18888,Catoosafdb13ab7505be16a2ad25cb94d9a448bbdf35511ddcbc7405d15e2f9bcf8b8f2
Charlton,fdb13ab7505be16a2ad25cb94d9a448bbdf35511ddcbc7405d15e2f9bcf8b8f2,1016,150,1319,4,2489,Charltonfdb13ab7505be16a2ad25cb94d9a448bbdf35511ddcbc7405d15e2f9bcf8b8f2
Chatham,fdb13ab7505be16a2ad25cb94d9a448bbdf35511ddcbc7405d15e2f9bcf8b8f2,32859,2214,14620,47,49740,Chathamfdb13ab7505be16a2ad25cb94d9a448bbdf35511ddcbc7405d15e2f9bcf8b8f2
Chattahoochee,fdb13ab7505be16a2ad25cb94d9a448bbdf35511ddcbc7405d15e2f9bcf8b8f2,390,36,269,5,700,Chattahoocheefdb13ab7505be16a2ad25cb94d9a448bbdf35511ddcbc7405d15e2f9bcf8b8f2
Chattooga,fdb13ab7505be16a2ad25cb94d9a448bbdf35511ddcbc7405d15e2f9bcf8b8f2,2697,147,2981,2,5827,Chattoogafdb13ab7505be16a2ad25cb94d9a448bbdf35511ddcbc7405d15e2f9bcf8b8f2
Cherokee,fdb13ab7505be16a2ad25cb94d9a448bbdf35511ddcbc7405d15e2f9bcf8b8f2,31598,3775,44777,16,80166,Cherokeefdb13ab7505be16a2ad25cb94d9a448bbdf35511ddcbc7405d15e2f9bcf8b8f2
Clarke,fdb13ab7505be16a2ad25cb94d9a448bbdf35511ddcbc7405d15e2f9bcf8b8f2,6969,1128,7407,25,15529,Clarkefdb13ab7505be16a2ad25cb94d9a448bbdf35511ddcbc7405d15e2f9bcf8b8f2
Clay,fdb13ab7505be16a2ad25cb94d9a448bbdf35511ddcbc7405d15e2f9bcf8b8f2,172,34,352,2,560,Clayfdb13ab7505be16a2ad25cb94d9a448bbdf35511ddcbc7405d15e2f9bcf8b8f2
Clayton,fdb13ab7505be16a2ad25cb94d9a448bbdf35511ddcbc7405d15e2f9bcf8b8f2,4781,994,9124,19,14918,Claytonfdb13ab7505be16a2ad25cb94d9a448bbdf35511ddcbc7405d15e2f9bcf8b8f2
Clinch,fdb13ab7505be16a2ad25cb94d9a448bbdf35511ddcbc7405d15e2f9bcf8b8f2,602,59,885,3,1549,Clinchfdb13ab7505be16a2ad25cb94d9a448bbdf35511ddcbc7405d15e2f9bcf8b8f2
Cobb,fdb13ab7505be16a2ad25cb94d9a448bbdf35511ddcbc7405d15e2f9bcf8b8f2,88936,14208,65847,278,169269,Cobbfdb13ab7505be16a2ad25cb94d9a448bbdf35511ddcbc7405d15e2f9bcf8b8f2
Coffee,fdb13ab7505be16a2ad25cb94d9a448bbdf35511ddcbc7405d15e2f9bcf8b8f2,2814,313,5756,0,8883,Coffeefdb13ab7505be16a2ad25cb94d9a448bbdf35511ddcbc7405d15e2f9bcf8b8f2
Colquitt,fdb13ab7505be16a2ad25cb94d9a448bbdf35511ddcbc7405d15e2f9bcf8b8f2,4838,285,4491,4,9618,Colquittfdb13ab7505be16a2ad25cb94d9a448bbdf35511ddcbc7405d15e2f9bcf8b8f2
Columbia,fdb13ab7505be16a2ad25cb94d9a448bbdf35511ddcbc7405d15e2f9bcf8b8f2,17265,1955,23652,19,42891,Columbiafdb13ab7505be16a2ad25cb94d9a448bbdf35511ddcbc7405d15e2f9bcf8b8f2
Cook,fdb13ab7505be16a2ad25cb94d9a448bbdf35511ddcbc7405d15e2f9bcf8b8f2,1545,156,2344,0,4045,Cookfdb13ab7505be16a2ad25cb94d9a448bbdf35511ddcbc7405d15e2f9bcf8b8f2
Coweta,fdb13ab7505be16a2ad25cb94d9a448bbdf35511ddcbc7405d15e2f9bcf8b8f2,18594,1993,21374,11,41972,Cowetafdb13ab7505be16a2ad25cb94d9a448bbdf35511ddcbc7405d15e2f9bcf8b8f2
Crawford,fdb13ab7505be16a2ad25cb94d9a448bbdf35511ddcbc7405d15e2f9bcf8b8f2,1526,164,1801,3,3494,Crawfordfdb13ab7505be16a2ad25cb94d9a448bbdf35511ddcbc7405d15e2f9bcf8b8f2
Crisp,fdb13ab7505be16a2ad25cb94d9a448bbdf35511ddcbc7405d15e2f9bcf8b8f2,1369,214,2955,8,4546,Crispfdb13ab7505be16a2ad25cb94d9a448bbdf35511ddcbc7405d15e2f9bcf8b8f2
Dade,fdb13ab7505be16a2ad25cb94d9a448bbdf35511ddcbc7405d15e2f9bcf8b8f2,2241,114,2091,2,4448,Dadefdb13ab7505be16a2ad25cb94d9a448bbdf35511ddcbc7405d15e2f9bcf8b8f2
Dawson,fdb13ab7505be16a2ad25cb94d9a448bbdf35511ddcbc7405d15e2f9bcf8b8f2,2303,422,6574,15,9314,Dawsonfdb13ab7505be16a2ad25cb94d9a448bbdf35511ddcbc7405d15e2f9bcf8b8f2
Decatur,fdb13ab7505be16a2ad25cb94d9a448bbdf35511ddcbc7405d15e2f9bcf8b8f2,2054,281,3248,10,5593,Decaturfdb13ab7505be16a2ad25cb94d9a448bbdf35511ddcbc7405d15e2f9bcf8b8f2
DeKalb,fdb13ab7505be16a2ad25cb94d9a448bbdf35511ddcbc7405d15e2f9bcf8b8f2,31038,5202,34682,72,70994,DeKalbfdb13ab7505be16a2ad25cb94d9a448bbdf35511ddcbc7405d15e2f9bcf8b8f2
Dodge,fdb13ab7505be16a2ad25cb94d9a448bbdf35511ddcbc7405d15e2f9bcf8b8f2,2541,238,1987,0,4766,Dodgefdb13ab7505be16a2ad25cb94d9a448bbdf35511ddcbc7405d15e2f9bcf8b8f2
Dooly,fdb13ab7505be16a2ad25cb94d9a448bbdf35511ddcbc7405d15e2f9bcf8b8f2,851,81,1082,8,2022,Doolyfdb13ab7505be16a2ad25cb94d9a448bbdf35511ddcbc7405d15e2f9bcf8b8f2
Dougherty,fdb13ab7505be16a2ad25cb94d9a448bbdf35511ddcbc7405d15e2f9bcf8b8f2,6214,599,4227,8,11048,Doughertyfdb13ab7505be16a2ad25cb94d9a448bbdf35511ddcbc7405d15e2f9bcf8b8f2
Douglas,fdb13ab7505be16a2ad25cb94d9a448bbdf35511ddcbc7405d15e2f9bcf8b8f2,7674,1253,16163,12,25102,Douglasfdb13ab7505be16a2ad25cb94d9a448bbdf35511ddcbc7405d15e2f9bcf8b8f2
Early,fdb13ab7505be16a2ad25cb94d9a448bbdf35511ddcbc7405d15e2f9bcf8b8f2,1071,136,1308,0,2515,Earlyfdb13ab7505be16a2ad25cb94d9a448bbdf35511ddcbc7405d15e2f9bcf8b8f2
Echols,fdb13ab7505be16a2ad25cb94d9a448bbdf35511ddcbc7405d15e2f9bcf8b8f2,331,37,506,0,874,Echolsfdb13ab7505be16a2ad25cb94d9a448bbdf35511ddcbc7405d15e2f9bcf8b8f2
Effingham,fdb13ab7505be16a2ad25cb94d9a448bbdf35511ddcbc7405d15e2f9bcf8b8f2,7840,438,9103,8,17389,Effinghamfdb13ab7505be16a2ad25cb94d9a448bbdf35511ddcbc7405d15e2f9bcf8b8f2
Elbert,fdb13ab7505be16a2ad25cb94d9a448bbdf35511ddcbc7405d15e2f9bcf8b8f2,1799,278,2859,24,4960,Elbertfdb13ab7505be16a2ad25cb94d9a448bbdf35511ddcbc7405d15e2f9bcf8b8f2
Emanuel,fdb13ab7505be16a2ad25cb94d9a448bbdf35511ddcbc7405d15e2f9bcf8b8f2,2633,222,2202,5,5062,Emanuelfdb13ab7505be16a2ad25cb94d9a448bbdf35511ddcbc7405d15e2f9bcf8b8f2
Evans,fdb13ab7505be16a2ad25cb94d9a448bbdf35511ddcbc7405d15e2f9bcf8b8f2,671,131,1593,0,2395,Evansfdb13ab7505be16a2ad25cb94d9a448bbdf35511ddcbc7405d15e2f9bcf8b8f2
Fannin,fdb13ab7505be16a2ad25cb94d9a448bbdf35511ddcbc7405d15e2f9bcf8b8f2,3908,596,4332,5,8841,Fanninfdb13ab7505be16a2ad25cb94d9a448bbdf35511ddcbc7405d15e2f9bcf8b8f2
Fayette,fdb13ab7505be16a2ad25cb94d9a448bbdf35511ddcbc7405d15e2f9bcf8b8f2,11324,1787,23237,8,36356,Fayettefdb13ab7505be16a2ad25cb94d9a448bbdf35511ddcbc7405d15e2f9bcf8b8f2
Floyd,fdb13ab7505be16a2ad25cb94d9a448bbdf35511ddcbc7405d15e2f9bcf8b8f2,9566,836,13010,68,23480,Floydfdb13ab7505be16a2ad25cb94d9a448bbdf35511ddcbc7405d15e2f9bcf8b8f2
Forsyth,fdb13ab7505be16a2ad25cb94d9a448bbdf35511ddcbc7405d15e2f9bcf8b8f2,17966,2716,50127,24,70833,Forsythfdb13ab7505be16a2ad25cb94d9a448bbdf35511ddcbc7405d15e2f9bcf8b8f2
Franklin,fdb13ab7505be16a2ad25cb94d9a448bbdf35511ddcbc7405d15e2f9bcf8b8f2,3016,323,3149,0,6488,Franklinfdb13ab7505be16a2ad25cb94d9a448bbdf35511ddcbc7405d15e2f9bcf8b8f2
Fulton,fdb13ab7505be16a2ad25cb94d9a448bbdf35511ddcbc7405d15e2f9bcf8b8f2,53088,9537,88803,261,151689,Fultonfdb13ab7505be16a2ad25cb94d9a448bbdf35511ddcbc7405d15e2f9bcf8b8f2
Gilmer,fdb13ab7505be16a2ad25cb94d9a448bbdf35511ddcbc7405d15e2f9bcf8b8f2,3990,503,5009,6,9508,Gilmerfdb13ab7505be16a2ad25cb94d9a448bbdf35511ddcbc7405d15e2f9bcf8b8f2
Glascock,fdb13ab7505be16a2ad25cb94d9a448bbdf35511ddcbc7405d15e2f9bcf8b8f2,475,57,569,0,1101,Glascockfdb13ab7505be16a2ad25cb94d9a448bbdf35511ddcbc7405d15e2f9bcf8b8f2
Glynn,fdb13ab7505be16a2ad25cb94d9a448bbdf35511ddcbc7405d15e2f9bcf8b8f2,8677,859,11324,27,20887,Glynnfdb13ab7505be16a2ad25cb94d9a448bbdf35511ddcbc7405d15e2f9bcf8b8f2
Gordon,fdb13ab7505be16a2ad25cb94d9a448bbdf35511ddcbc7405d15e2f9bcf8b8f2,6626,424,7026,16,14092,Gordonfdb13ab7505be16a2ad25cb94d9a448bbdf35511ddcbc7405d15e2f9bcf8b8f2
Grady,fdb13ab7505be16a2ad25cb94d9a448bbdf35511ddcbc7405d15e2f9bcf8b8f2,2348,176,3006,4,5534,Gradyfdb13ab7505be16a2ad25cb94d9a448bbdf35511ddcbc7405d15e2f9bcf8b8f2
Greene,fdb13ab7505be16a2ad25cb94d9a448bbdf35511ddcbc7405d15e2f9bcf8b8f2,1487,296,3950,2,5735,Greenefdb13ab7505be16a2ad25cb94d9a448bbdf35511ddcbc7405d15e2f9bcf8b8f2
Gwinnett,fdb13ab7505be16a2ad25cb94d9a448bbdf35511ddcbc7405d15e2f9bcf8b8f2,76444,11254,66352,522,154572,Gwinnettfdb13ab7505be16a2ad25cb94d9a448bbdf35511ddcbc7405d15e2f9bcf8b8f2
Habersham,fdb13ab7505be16a2ad25cb94d9a448bbdf35511ddcbc7405d15e2f9bcf8b8f2,2388,733,9369,3,12493,Habershamfdb13ab7505be16a2ad25cb94d9a448bbdf35511ddcbc7405d15e2f9bcf8b8f2
Hall,fdb13ab7505be16a2ad25cb94d9a448bbdf35511ddcbc7405d15e2f9bcf8b8f2,22804,2504,24778,38,50124,Hallfdb13ab7505be16a2ad25cb94d9a448bbdf35511ddcbc7405d15e2f9bcf8b8f2
Hancock,fdb13ab7505be16a2ad25cb94d9a448bbdf35511ddcbc7405d15e2f9bcf8b8f2,434,54,455,3,946,Hancockfdb13ab7505be16a2ad25cb94d9a448bbdf35511ddcbc7405d15e2f9bcf8b8f2
Haralson,fdb13ab7505be16a2ad25cb94d9a448bbdf35511ddcbc7405d15e2f9bcf8b8f2,4323,344,4162,4,8833,Haralsonfdb13ab7505be16a2ad25cb94d9a448bbdf35511ddcbc7405d15e2f9bcf8b8f2
Harris,fdb13ab7505be16a2ad25cb94d9a448bbdf35511ddcbc7405d15e2f9bcf8b8f2,4915,482,6210,1,11608,Harrisfdb13ab7505be16a2ad25cb94d9a448bbdf35511ddcbc7405d15e2f9bcf8b8f2
Hart,fdb13ab7505be16a2ad25cb94d9a448bbdf35511ddcbc7405d15e2f9bcf8b8f2,2804,298,3601,0,6703,Hartfdb13ab7505be16a2ad25cb94d9a448bbdf35511ddcbc7405d15e2f9bcf8b8f2
Heard,fdb13ab7505be16a2ad25cb94d9a448bbdf35511ddcbc7405d15e2f9bcf8b8f2,1683,189,1226,1,3099,Heardfdb13ab7505be16a2ad25cb94d9a448bbdf35511ddcbc7405d15e2f9bcf8b8f2
Henry,fdb13ab7505be16a2ad25cb94d9a448bbdf35511ddcbc7405d15e2f9bcf8b8f2,11605,1865,31697,67,45234,Henryfdb13ab7505be16a2ad25cb94d9a448bbdf35511ddcbc7405d15e2f9bcf8b8f2
Houston,fdb13ab7505be16a2ad25cb94d9a448bbdf35511ddcbc7405d15e2f9bcf8b8f2,10594,1571,23069,55,35289,Houstonfdb13ab7505be16a2ad25cb94d9a448bbdf35511ddcbc7405d15e2f9bcf8b8f2
Irwin,fdb13ab7505be16a2ad25cb94d9a448bbdf35511ddcbc7405d15e2f9bcf8b8f2,1207,80,1289,5,2581,Irwinfdb13ab7505be16a2ad25cb94d9a448bbdf35511ddcbc7405d15e2f9bcf8b8f2
Jackson,fdb13ab7505be16a2ad25cb94d9a448bbdf35511ddcbc7405d15e2f9bcf8b8f2,7496,631,12808,30,20965,Jacksonfdb13ab7505be16a2ad25cb94d9a448bbdf35511ddcbc7405d15e2f9bcf8b8f2
Jasper,fdb13ab7505be16a2ad25cb94d9a448bbdf35511ddcbc7405d15e2f9bcf8b8f2,1593,221,2360,6,4180,Jasperfdb13ab7505be16a2ad25cb94d9a448bbdf35511ddcbc7405d15e2f9bcf8b8f2
Jeff Davis,fdb13ab7505be16a2ad25cb94d9a448bbdf35511ddcbc7405d15e2f9bcf8b8f2,1633,155,1926,2,3716,Jeff Davisfdb13ab7505be16a2ad25cb94d9a448bbdf35511ddcbc7405d15e2f9bcf8b8f2
Jefferson,fdb13ab7505be16a2ad25cb94d9a448bbdf35511ddcbc7405d15e2f9bcf8b8f2,1485,169,1380,6,3040,Jeffersonfdb13ab7505be16a2ad25cb94d9a448bbdf35511ddcbc7405d15e2f9bcf8b8f2
Jenkins,fdb13ab7505be16a2ad25cb94d9a448bbdf35511ddcbc7405d15e2f9bcf8b8f2,701,93,1030,2,1826,Jenkinsfdb13ab7505be16a2ad25cb94d9a448bbdf35511ddcbc7405d15e2f9bcf8b8f2
Johnson,fdb13ab7505be16a2ad25cb94d9a448bbdf35511ddcbc7405d15e2f9bcf8b8f2,910,140,1323,0,2373,Johnsonfdb13ab7505be16a2ad25cb94d9a448bbdf35511ddcbc7405d15e2f9bcf8b8f2
Jones,fdb13ab7505be16a2ad25cb94d9a448bbdf35511ddcbc7405d15e2f9bcf8b8f2,3012,415,4697,1,8125,Jonesfdb13ab7505be16a2ad25cb94d9a448bbdf35511ddcbc7405d15e2f9bcf8b8f2
Lamar,fdb13ab7505be16a2ad25cb94d9a448bbdf35511ddcbc7405d15e2f9bcf8b8f2,1881,212,2829,7,4929,Lamarfdb13ab7505be16a2ad25cb94d9a448bbdf35511ddcbc7405d15e2f9bcf8b8f2
Lanier,fdb13ab7505be16a2ad25cb94d9a448bbdf35511ddcbc7405d15e2f9bcf8b8f2,731,45,1016,0,1792,Lanierfdb13ab7505be16a2ad25cb94d9a448bbdf35511ddcbc7405d15e2f9bcf8b8f2
Laurens,fdb13ab7505be16a2ad25cb94d9a448bbdf35511ddcbc7405d15e2f9bcf8b8f2,6417,690,5340,2,12449,Laurensfdb13ab7505be16a2ad25cb94d9a448bbdf35511ddcbc7405d15e2f9bcf8b8f2
Lee,fdb13ab7505be16a2ad25cb94d9a448bbdf35511ddcbc7405d15e2f9bcf8b8f2,4767,326,5208,4,10305,Leefdb13ab7505be16a2ad25cb94d9a448bbdf35511ddcbc7405d15e2f9bcf8b8f2
Liberty,fdb13ab7505be16a2ad25cb94d9a448bbdf35511ddcbc7405d15e2f9bcf8b8f2,2808,289,3392,8,6497,Libertyfdb13ab7505be16a2ad25cb94d9a448bbdf35511ddcbc7405d15e2f9bcf8b8f2
Lincoln,fdb13ab7505be16a2ad25cb94d9a448bbdf35511ddcbc7405d15e2f9bcf8b8f2,1040,153,1478,0,2671,Lincolnfdb13ab7505be16a2ad25cb94d9a448bbdf35511ddcbc7405d15e2f9bcf8b8f2
Long,fdb13ab7505be16a2ad25cb94d9a448bbdf35511ddcbc7405d15e2f9bcf8b8f2,1272,48,1200,4,2524,Longfdb13ab7505be16a2ad25cb94d9a448bbdf35511ddcbc7405d15e2f9bcf8b8f2
Lowndes,fdb13ab7505be16a2ad25cb94d9a448bbdf35511ddcbc7405d15e2f9bcf8b8f2,6290,836,13480,196,20802,Lowndesfdb13ab7505be16a2ad25cb94d9a448bbdf35511ddcbc7405d15e2f9bcf8b8f2
Lumpkin,fdb13ab7505be16a2ad25cb94d9a448bbdf35511ddcbc7405d15e2f9bcf8b8f2,2069,398,6724,6,9197,Lumpkinfdb13ab7505be16a2ad25cb94d9a448bbdf35511ddcbc7405d15e2f9bcf8b8f2
Macon,fdb13ab7505be16a2ad25cb94d9a448bbdf35511ddcbc7405d15e2f9bcf8b8f2,587,82,1009,0,1678,Maconfdb13ab7505be16a2ad25cb94d9a448bbdf35511ddcbc7405d15e2f9bcf8b8f2
Madison,fdb13ab7505be16a2ad25cb94d9a448bbdf35511ddcbc7405d15e2f9bcf8b8f2,3861,372,4588,7,8828,Madisonfdb13ab7505be16a2ad25cb94d9a448bbdf35511ddcbc7405d15e2f9bcf8b8f2
Marion,fdb13ab7505be16a2ad25cb94d9a448bbdf35511ddcbc7405d15e2f9bcf8b8f2,1028,74,743,0,1845,Marionfdb13ab7505be16a2ad25cb94d9a448bbdf35511ddcbc7405d15e2f9bcf8b8f2
McDuffie,fdb13ab7505be16a2ad25cb94d9a448bbdf35511ddcbc7405d15e2f9bcf8b8f2,1821,287,3145,0,5253,McDuffiefdb13ab7505be16a2ad25cb94d9a448bbdf35511ddcbc7405d15e2f9bcf8b8f2
McIntosh,fdb13ab7505be16a2ad25cb94d9a448bbdf35511ddcbc7405d15e2f9bcf8b8f2,1225,391,1798,6,3420,McIntoshfdb13ab7505be16a2ad25cb94d9a448bbdf35511ddcbc7405d15e2f9bcf8b8f2
Meriwether,fdb13ab7505be16a2ad25cb94d9a448bbdf35511ddcbc7405d15e2f9bcf8b8f2,2889,213,2054,2,5158,Meriwetherfdb13ab7505be16a2ad25cb94d9a448bbdf35511ddcbc7405d15e2f9bcf8b8f2
Miller,fdb13ab7505be16a2ad25cb94d9a448bbdf35511ddcbc7405d15e2f9bcf8b8f2,701,99,906,3,1709,Millerfdb13ab7505be16a2ad25cb94d9a448bbdf35511ddcbc7405d15e2f9bcf8b8f2
Mitchell,fdb13ab7505be16a2ad25cb94d9a448bbdf35511ddcbc7405d15e2f9bcf8b8f2,2007,208,2021,7,4243,Mitchellfdb13ab7505be16a2ad25cb94d9a448bbdf35511ddcbc7405d15e2f9bcf8b8f2
Monroe,fdb13ab7505be16a2ad25cb94d9a448bbdf35511ddcbc7405d15e2f9bcf8b8f2,4082,316,4314,7,8719,Monroefdb13ab7505be16a2ad25cb94d9a448bbdf35511ddcbc7405d15e2f9bcf8b8f2
Montgomery,fdb13ab7505be16a2ad25cb94d9a448bbdf35511ddcbc7405d15e2f9bcf8b8f2,1500,88,944,0,2532,Montgomeryfdb13ab7505be16a2ad25cb94d9a448bbdf35511ddcbc7405d15e2f9bcf8b8f2
Morgan,fdb13ab7505be16a2ad25cb94d9a448bbdf35511ddcbc7405d15e2f9bcf8b8f2,2444,235,3853,1,6533,Morganfdb13ab7505be16a2ad25cb94d9a448bbdf35511ddcbc7405d15e2f9bcf8b8f2
Murray,fdb13ab7505be16a2ad25cb94d9a448bbdf35511ddcbc7405d15e2f9bcf8b8f2,4546,244,4132,0,8922,Murrayfdb13ab7505be16a2ad25cb94d9a448bbdf35511ddcbc7405d15e2f9bcf8b8f2
Muscogee,fdb13ab7505be16a2ad25cb94d9a448bbdf35511ddcbc7405d15e2f9bcf8b8f2,13300,1817,12787,36,27940,Muscogeefdb13ab7505be16a2ad25cb94d9a448bbdf35511ddcbc7405d15e2f9bcf8b8f2
Newton,fdb13ab7505be16a2ad25cb94d9a448bbdf35511ddcbc7405d15e2f9bcf8b8f2,10178,1046,9358,2,20584,Newtonfdb13ab7505be16a2ad25cb94d9a448bbdf35511ddcbc7405d15e2f9bcf8b8f2
Oconee,fdb13ab7505be16a2ad25cb94d9a448bbdf35511ddcbc7405d15e2f9bcf8b8f2,5555,609,8177,3,14344,Oconeefdb13ab7505be16a2ad25cb94d9a448bbdf35511ddcbc7405d15e2f9bcf8b8f2
Oglethorpe,fdb13ab7505be16a2ad25cb94d9a448bbdf35511ddcbc7405d15e2f9bcf8b8f2,1503,276,2722,1,4502,Oglethorpefdb13ab7505be16a2ad25cb94d9a448bbdf35511ddcbc7405d15e2f9bcf8b8f2
Paulding,fdb13ab7505be16a2ad25cb94d9a448bbdf35511ddcbc7405d15e2f9bcf8b8f2,11839,2129,28994,12,42974,Pauldingfdb13ab7505be16a2ad25cb94d9a448bbdf35511ddcbc7405d15e2f9bcf8b8f2
Peach,fdb13ab7505be16a2ad25cb94d9a448bbdf35511ddcbc7405d15e2f9bcf8b8f2,1513,173,3723,10,5419,Peachfdb13ab7505be16a2ad25cb94d9a448bbdf35511ddcbc7405d15e2f9bcf8b8f2
Pickens,fdb13ab7505be16a2ad25cb94d9a448bbdf35511ddcbc7405d15e2f9bcf8b8f2,4138,215,6648,0,11001,Pickensfdb13ab7505be16a2ad25cb94d9a448bbdf35511ddcbc7405d15e2f9bcf8b8f2
Pierce,fdb13ab7505be16a2ad25cb94d9a448bbdf35511ddcbc7405d15e2f9bcf8b8f2,1595,291,3931,0,5817,Piercefdb13ab7505be16a2ad25cb94d9a448bbdf35511ddcbc7405d15e2f9bcf8b8f2
Pike,fdb13ab7505be16a2ad25cb94d9a448bbdf35511ddcbc7405d15e2f9bcf8b8f2,2532,286,4089,6,6913,Pikefdb13ab7505be16a2ad25cb94d9a448bbdf35511ddcbc7405d15e2f9bcf8b8f2
Polk,fdb13ab7505be16a2ad25cb94d9a448bbdf35511ddcbc7405d15e2f9bcf8b8f2,3132,339,6744,4,10219,Polkfdb13ab7505be16a2ad25cb94d9a448bbdf35511ddcbc7405d15e2f9bcf8b8f2
Pulaski,fdb13ab7505be16a2ad25cb94d9a448bbdf35511ddcbc7405d15e2f9bcf8b8f2,548,119,1747,1,2415,Pulaskifdb13ab7505be16a2ad25cb94d9a448bbdf35511ddcbc7405d15e2f9bcf8b8f2
Putnam,fdb13ab7505be16a2ad25cb94d9a448bbdf35511ddcbc7405d15e2f9bcf8b8f2,2297,369,3765,4,6435,Putnamfdb13ab7505be16a2ad25cb94d9a448bbdf35511ddcbc7405d15e2f9bcf8b8f2
Quitman,fdb13ab7505be16a2ad25cb94d9a448bbdf35511ddcbc7405d15e2f9bcf8b8f2,209,33,259,0,501,Quitmanfdb13ab7505be16a2ad25cb94d9a448bbdf35511ddcbc7405d15e2f9bcf8b8f2
Rabun,fdb13ab7505be16a2ad25cb94d9a448bbdf35511ddcbc7405d15e2f9bcf8b8f2,1035,678,4264,0,5977,Rabunfdb13ab7505be16a2ad25cb94d9a448bbdf35511ddcbc7405d15e2f9bcf8b8f2
Randolph,fdb13ab7505be16a2ad25cb94d9a448bbdf35511ddcbc7405d15e2f9bcf8b8f2,671,40,581,1,1293,Randolphfdb13ab7505be16a2ad25cb94d9a448bbdf35511ddcbc7405d15e2f9bcf8b8f2
Richmond,fdb13ab7505be16a2ad25cb94d9a448bbdf35511ddcbc7405d15e2f9bcf8b8f2,12764,1755,11371,18,25908,Richmondfdb13ab7505be16a2ad25cb94d9a448bbdf35511ddcbc7405d15e2f9bcf8b8f2
Rockdale,fdb13ab7505be16a2ad25cb94d9a448bbdf35511ddcbc7405d15e2f9bcf8b8f2,3723,675,9486,9,13893,Rockdalefdb13ab7505be16a2ad25cb94d9a448bbdf35511ddcbc7405d15e2f9bcf8b8f2
Schley,fdb13ab7505be16a2ad25cb94d9a448bbdf35511ddcbc7405d15e2f9bcf8b8f2,421,53,971,0,1445,Schleyfdb13ab7505be16a2ad25cb94d9a448bbdf35511ddcbc7405d15e2f9bcf8b8f2
Screven,fdb13ab7505be16a2ad25cb94d9a448bbdf35511ddcbc7405d15e2f9bcf8b8f2,1479,98,1712,0,3289,Screvenfdb13ab7505be16a2ad25cb94d9a448bbdf35511ddcbc7405d15e2f9bcf8b8f2
Seminole,fdb13ab7505be16a2ad25cb94d9a448bbdf35511ddcbc7405d15e2f9bcf8b8f2,1112,115,842,1,2070,Seminolefdb13ab7505be16a2ad25cb94d9a448bbdf35511ddcbc7405d15e2f9bcf8b8f2
Spalding,fdb13ab7505be16a2ad25cb94d9a448bbdf35511ddcbc7405d15e2f9bcf8b8f2,5284,640,9241,7,15172,Spaldingfdb13ab7505be16a2ad25cb94d9a448bbdf35511ddcbc7405d15e2f9bcf8b8f2
Stephens,fdb13ab7505be16a2ad25cb94d9a448bbdf35511ddcbc7405d15e2f9bcf8b8f2,1397,485,5400,2,7284,Stephensfdb13ab7505be16a2ad25cb94d9a448bbdf35511ddcbc7405d15e2f9bcf8b8f2
Stewart,fdb13ab7505be16a2ad25cb94d9a448bbdf35511ddcbc7405d15e2f9bcf8b8f2,344,141,319,3,807,Stewartfdb13ab7505be16a2ad25cb94d9a448bbdf35511ddcbc7405d15e2f9bcf8b8f2
Sumter,fdb13ab7505be16a2ad25cb94d9a448bbdf35511ddcbc7405d15e2f9bcf8b8f2,2365,292,2761,0,5418,Sumterfdb13ab7505be16a2ad25cb94d9a448bbdf35511ddcbc7405d15e2f9bcf8b8f2
Talbot,fdb13ab7505be16a2ad25cb94d9a448bbdf35511ddcbc7405d15e2f9bcf8b8f2,732,130,366,0,1228,Talbotfdb13ab7505be16a2ad25cb94d9a448bbdf35511ddcbc7405d15e2f9bcf8b8f2
Taliaferro,fdb13ab7505be16a2ad25cb94d9a448bbdf35511ddcbc7405d15e2f9bcf8b8f2,162,17,162,0,341,Taliaferrofdb13ab7505be16a2ad25cb94d9a448bbdf35511ddcbc7405d15e2f9bcf8b8f2
Tattnall,fdb13ab7505be16a2ad25cb94d9a448bbdf35511ddcbc7405d15e2f9bcf8b8f2,1850,445,2662,3,4960,Tattnallfdb13ab7505be16a2ad25cb94d9a448bbdf35511ddcbc7405d15e2f9bcf8b8f2
Taylor,fdb13ab7505be16a2ad25cb94d9a448bbdf35511ddcbc7405d15e2f9bcf8b8f2,665,112,1197,0,1974,Taylorfdb13ab7505be16a2ad25cb94d9a448bbdf35511ddcbc7405d15e2f9bcf8b8f2
Telfair,fdb13ab7505be16a2ad25cb94d9a448bbdf35511ddcbc7405d15e2f9bcf8b8f2,1241,119,966,1,2327,Telfairfdb13ab7505be16a2ad25cb94d9a448bbdf35511ddcbc7405d15e2f9bcf8b8f2
Terrell,fdb13ab7505be16a2ad25cb94d9a448bbdf35511ddcbc7405d15e2f9bcf8b8f2,918,107,970,2,1997,Terrellfdb13ab7505be16a2ad25cb94d9a448bbdf35511ddcbc7405d15e2f9bcf8b8f2
Thomas,fdb13ab7505be16a2ad25cb94d9a448bbdf35511ddcbc7405d15e2f9bcf8b8f2,4087,468,6264,4,10823,Thomasfdb13ab7505be16a2ad25cb94d9a448bbdf35511ddcbc7405d15e2f9bcf8b8f2
Tift,fdb13ab7505be16a2ad25cb94d9a448bbdf35511ddcbc7405d15e2f9bcf8b8f2,3612,356,5533,9,9510,Tiftfdb13ab7505be16a2ad25cb94d9a448bbdf35511ddcbc7405d15e2f9bcf8b8f2
Toombs,fdb13ab7505be16a2ad25cb94d9a448bbdf35511ddcbc7405d15e2f9bcf8b8f2,2454,355,3556,2,6367,Toombsfdb13ab7505be16a2ad25cb94d9a448bbdf35511ddcbc7405d15e2f9bcf8b8f2
Towns,fdb13ab7505be16a2ad25cb94d9a448bbdf35511ddcbc7405d15e2f9bcf8b8f2,1341,294,3322,7,4964,Townsfdb13ab7505be16a2ad25cb94d9a448bbdf35511ddcbc7405d15e2f9bcf8b8f2
Treutlen,fdb13ab7505be16a2ad25cb94d9a448bbdf35511ddcbc7405d15e2f9bcf8b8f2,558,108,1033,1,1700,Treutlenfdb13ab7505be16a2ad25cb94d9a448bbdf35511ddcbc7405d15e2f9bcf8b8f2
Troup,fdb13ab7505be16a2ad25cb94d9a448bbdf35511ddcbc7405d15e2f9bcf8b8f2,6503,743,7936,111,15293,Troupfdb13ab7505be16a2ad25cb94d9a448bbdf35511ddcbc7405d15e2f9bcf8b8f2
Turner,fdb13ab7505be16a2ad25cb94d9a448bbdf35511ddcbc7405d15e2f9bcf8b8f2,616,51,1371,1,2039,Turnerfdb13ab7505be16a2ad25cb94d9a448bbdf35511ddcbc7405d15e2f9bcf8b8f2
Twiggs,fdb13ab7505be16a2ad25cb94d9a448bbdf35511ddcbc7405d15e2f9bcf8b8f2,1112,98,764,1,1975,Twiggsfdb13ab7505be16a2ad25cb94d9a448bbdf35511ddcbc7405d15e2f9bcf8b8f2
Union,fdb13ab7505be16a2ad25cb94d9a448bbdf35511ddcbc7405d15e2f9bcf8b8f2,3063,459,5656,3,9181,Unionfdb13ab7505be16a2ad25cb94d9a448bbdf35511ddcbc7405d15e2f9bcf8b8f2
Upson,fdb13ab7505be16a2ad25cb94d9a448bbdf35511ddcbc7405d15e2f9bcf8b8f2,1651,318,5091,3,7063,Upsonfdb13ab7505be16a2ad25cb94d9a448bbdf35511ddcbc7405d15e2f9bcf8b8f2
Walker,fdb13ab7505be16a2ad25cb94d9a448bbdf35511ddcbc7405d15e2f9bcf8b8f2,6518,703,9858,7,17086,Walkerfdb13ab7505be16a2ad25cb94d9a448bbdf35511ddcbc7405d15e2f9bcf8b8f2
Walton,fdb13ab7505be16a2ad25cb94d9a448bbdf35511ddcbc7405d15e2f9bcf8b8f2,15345,1275,13079,24,29723,Waltonfdb13ab7505be16a2ad25cb94d9a448bbdf35511ddcbc7405d15e2f9bcf8b8f2
Ware,fdb13ab7505be16a2ad25cb94d9a448bbdf35511ddcbc7405d15e2f9bcf8b8f2,3366,363,4140,3,7872,Warefdb13ab7505be16a2ad25cb94d9a448bbdf35511ddcbc7405d15e2f9bcf8b8f2
Warren,fdb13ab7505be16a2ad25cb94d9a448bbdf35511ddcbc7405d15e2f9bcf8b8f2,311,69,613,0,993,Warrenfdb13ab7505be16a2ad25cb94d9a448bbdf35511ddcbc7405d15e2f9bcf8b8f2
Washington,fdb13ab7505be16a2ad25cb94d9a448bbdf35511ddcbc7405d15e2f9bcf8b8f2,1745,273,2065,9,4092,Washingtonfdb13ab7505be16a2ad25cb94d9a448bbdf35511ddcbc7405d15e2f9bcf8b8f2
Wayne,fdb13ab7505be16a2ad25cb94d9a448bbdf35511ddcbc7405d15e2f9bcf8b8f2,3197,308,4173,8,7686,Waynefdb13ab7505be16a2ad25cb94d9a448bbdf35511ddcbc7405d15e2f9bcf8b8f2
Webster,fdb13ab7505be16a2ad25cb94d9a448bbdf35511ddcbc7405d15e2f9bcf8b8f2,251,67,331,0,649,Websterfdb13ab7505be16a2ad25cb94d9a448bbdf35511ddcbc7405d15e2f9bcf8b8f2
Wheeler,fdb13ab7505be16a2ad25cb94d9a448bbdf35511ddcbc7405d15e2f9bcf8b8f2,609,98,594,3,1304,Wheelerfdb13ab7505be16a2ad25cb94d9a448bbdf35511ddcbc7405d15e2f9bcf8b8f2
White,fdb13ab7505be16a2ad25cb94d9a448bbdf35511ddcbc7405d15e2f9bcf8b8f2,3840,478,4886,8,9212,Whitefdb13ab7505be16a2ad25cb94d9a448bbdf35511ddcbc7405d15e2f9bcf8b8f2
Whitfield,fdb13ab7505be16a2ad25cb94d9a448bbdf35511ddcbc7405d15e2f9bcf8b8f2,10003,765,9018,22,19808,Whitfieldfdb13ab7505be16a2ad25cb94d9a448bbdf35511ddcbc7405d15e2f9bcf8b8f2
Wilcox,fdb13ab7505be16a2ad25cb94d9a448bbdf35511ddcbc7405d15e2f9bcf8b8f2,964,173,899,0,2036,Wilcoxfdb13ab7505be16a2ad25cb94d9a448bbdf35511ddcbc7405d15e2f9bcf8b8f2
Wilkes,fdb13ab7505be16a2ad25cb94d9a448bbdf35511ddcbc7405d15e2f9bcf8b8f2,1142,92,1269,4,2507,Wilkesfdb13ab7505be16a2ad25cb94d9a448bbdf35511ddcbc7405d15e2f9bcf8b8f2
Wilkinson,fdb13ab7505be16a2ad25cb94d9a448bbdf35511ddcbc7405d15e2f9bcf8b8f2,1441,86,738,1,2266,Wilkinsonfdb13ab7505be16a2ad25cb94d9a448bbdf35511ddcbc7405d15e2f9bcf8b8f2
Worth,fdb13ab7505be16a2ad25cb94d9a448bbdf35511ddcbc7405d15e2f9bcf8b8f2,3261,174,2442,7,5884,Worthfdb13ab7505be16a2ad25cb94d9a448bbdf35511ddcbc7405d15e2f9bcf8b8f2
Appling,361565da1fa79e975a662ad464f678b6d32743ef2ef248123b39354801631470,564,149,474,0,1187,Appling361565da1fa79e975a662ad464f678b6d32743ef2ef248123b39354801631470
Atkinson,361565da1fa79e975a662ad464f678b6d32743ef2ef248123b39354801631470,307,25,263,1,596,Atkinson361565da1fa79e975a662ad464f678b6d32743ef2ef248123b39354801631470
Bacon,361565da1fa79e975a662ad464f678b6d32743ef2ef248123b39354801631470,205,34,234,1,474,Bacon361565da1fa79e975a662ad464f678b6d32743ef2ef248123b39354801631470
Baker,361565da1fa79e975a662ad464f678b6d32743ef2ef248123b39354801631470,259,66,205,1,531,Baker361565da1fa79e975a662ad464f678b6d32743ef2ef248123b39354801631470
Baldwin,361565da1fa79e975a662ad464f678b6d32743ef2ef248123b39354801631470,2716,684,3382,5,6787,Baldwin361565da1fa79e975a662ad464f678b6d32743ef2ef248123b39354801631470
Banks,361565da1fa79e975a662ad464f678b6d32743ef2ef248123b39354801631470,349,40,284,0,673,Banks361565da1fa79e975a662ad464f678b6d32743ef2ef248123b39354801631470
Barrow,361565da1fa79e975a662ad464f678b6d32743ef2ef248123b39354801631470,2433,358,2899,1,5691,Barrow361565da1fa79e975a662ad464f678b6d32743ef2ef248123b39354801631470
Bartow,361565da1fa79e975a662ad464f678b6d32743ef2ef248123b39354801631470,3608,406,3270,7,7291,Bartow361565da1fa79e975a662ad464f678b6d32743ef2ef248123b39354801631470
Ben Hill,361565da1fa79e975a662ad464f678b6d32743ef2ef248123b39354801631470,556,112,1069,2,1739,Ben Hill361565da1fa79e975a662ad464f678b6d32743ef2ef248123b39354801631470
Berrien,361565da1fa79e975a662ad464f678b6d32743ef2ef248123b39354801631470,434,80,375,6,895,Berrien361565da1fa79e975a662ad464f678b6d32743ef2ef248123b39354801631470
Bibb,361565da1fa79e975a662ad464f678b6d32743ef2ef248123b39354801631470,13774,2034,15579,146,31533,Bibb361565da1fa79e975a662ad464f678b6d32743ef2ef248123b39354801631470
Bleckley,361565da1fa79e975a662ad464f678b6d32743ef2ef248123b39354801631470,403,104,410,6,923,Bleckley361565da1fa79e975a662ad464f678b6d32743ef2ef248123b39354801631470
Brantley,361565da1fa79e975a662ad464f678b6d32743ef2ef248123b39354801631470,311,32,266,2,611,Brantley361565da1fa79e975a662ad464f678b6d32743ef2ef248123b39354801631470
Brooks,361565da1fa79e975a662ad464f678b6d32743ef2ef248123b39354801631470,855,421,792,24,2092,Brooks361565da1fa79e975a662ad464f678b6d32743ef2ef248123b39354801631470
Bryan,361565da1fa79e975a662ad464f678b6d32743ef2ef248123b39354801631470,1181,200,1833,2,3216,Bryan361565da1fa79e975a662ad464f678b6d32743ef2ef248123b39354801631470
Bulloch,361565da1fa79e975a662ad464f678b6d32743ef2ef248123b39354801631470,3289,380,4052,17,7738,Bulloch361565da1fa79e975a662ad464f678b6d32743ef2ef248123b39354801631470
Burke,361565da1fa79e975a662ad464f678b6d32743ef2ef248123b39354801631470,2113,630,1325,0,4068,Burke361565da1fa79e975a662ad464f678b6d32743ef2ef248123b39354801631470
Butts,361565da1fa79e975a662ad464f678b6d32743ef2ef248123b39354801631470,716,76,1375,0,2167,Butts361565da1fa79e975a662ad464f678b6d32743ef2ef248123b39354801631470
Calhoun,361565da1fa79e975a662ad464f678b6d32743ef2ef248123b39354801631470,627,101,277,2,1007,Calhoun361565da1fa79e975a662ad464f678b6d32743ef2ef248123b39354801631470
Camden,361565da1fa79e975a662ad464f678b6d32743ef2ef248123b39354801631470,1785,424,2884,4,5097,Camden361565da1fa79e975a662ad464f678b6d32743ef2ef248123b39354801631470
Candler,361565da1fa79e975a662ad464f678b6d32743ef2ef248123b39354801631470,309,44,501,1,855,Candler361565da1fa79e975a662ad464f678b6d32743ef2ef248123b39354801631470
Carroll,361565da1fa79e975a662ad464f678b6d32743ef2ef248123b39354801631470,4391,487,5952,37,10867,Carroll361565da1fa79e975a662ad464f678b6d32743ef2ef248123b39354801631470
Catoosa,361565da1fa79e975a662ad464f678b6d32743ef2ef248123b39354801631470,1424,159,2538,0,4121,Catoosa361565da1fa79e975a662ad464f678b6d32743ef2ef248123b39354801631470
Charlton,361565da1fa79e975a662ad464f678b6d32743ef2ef248123b39354801631470,377,52,442,2,873,Charlton361565da1fa79e975a662ad464f678b6d32743ef2ef248123b39354801631470
Chatham,361565da1fa79e975a662ad464f678b6d32743ef2ef248123b39354801631470,31563,2684,17844,55,52146,Chatham361565da1fa79e975a662ad464f678b6d32743ef2ef248123b39354801631470
Chattahoochee,361565da1fa79e975a662ad464f678b6d32743ef2ef248123b39354801631470,235,24,248,1,508,Chattahoochee361565da1fa79e975a662ad464f678b6d32743ef2ef248123b39354801631470
Chattooga,361565da1fa79e975a662ad464f678b6d32743ef2ef248123b39354801631470,762,72,786,2,1622,Chattooga361565da1fa79e975a662ad464f678b6d32743ef2ef248123b39354801631470
Cherokee,361565da1fa79e975a662ad464f678b6d32743ef2ef248123b39354801631470,8284,1290,11137,6,20717,Cherokee361565da1fa79e975a662ad464f678b6d32743ef2ef248123b39354801631470
Clarke,361565da1fa79e975a662ad464f678b6d32743ef2ef248123b39354801631470,10142,1433,13848,51,25474,Clarke361565da1fa79e975a662ad464f678b6d32743ef2ef248123b39354801631470
Clay,361565da1fa79e975a662ad464f678b6d32743ef2ef248123b39354801631470,300,67,206,1,574,Clay361565da1fa79e975a662ad464f678b6d32743ef2ef248123b39354801631470
Clayton,361565da1fa79e975a662ad464f678b6d32743ef2ef248123b39354801631470,25440,2009,41828,123,69400,Clayton361565da1fa79e975a662ad464f678b6d32743ef2ef248123b39354801631470
Clinch,361565da1fa79e975a662ad464f678b6d32743ef2ef248123b39354801631470,236,20,237,0,493,Clinch361565da1fa79e975a662ad464f678b6d32743ef2ef248123b39354801631470
Cobb,361565da1fa79e975a662ad464f678b6d32743ef2ef248123b39354801631470,60925,8215,64322,409,133871,Cobb361565da1fa79e975a662ad464f678b6d32743ef2ef248123b39354801631470
Coffee,361565da1fa79e975a662ad464f678b6d32743ef2ef248123b39354801631470,1428,150,1916,0,3494,Coffee361565da1fa79e975a662ad464f678b6d32743ef2ef248123b39354801631470
Colquitt,361565da1fa79e975a662ad464f678b6d32743ef2ef248123b39354801631470,1369,151,1204,2,2726,Colquitt361565da1fa79e975a662ad464f678b6d32743ef2ef248123b39354801631470
Columbia,361565da1fa79e975a662ad464f678b6d32743ef2ef248123b39354801631470,6053,1109,8629,9,15800,Columbia361565da1fa79e975a662ad464f678b6d32743ef2ef248123b39354801631470
Cook,361565da1fa79e975a662ad464f678b6d32743ef2ef248123b39354801631470,748,63,651,0,1462,Cook361565da1fa79e975a662ad464f678b6d32743ef2ef248123b39354801631470
Coweta,361565da1fa79e975a662ad464f678b6d32743ef2ef248123b39354801631470,6207,772,7102,7,14088,Coweta361565da1fa79e975a662ad464f678b6d32743ef2ef248123b39354801631470
Crawford,361565da1fa79e975a662ad464f678b6d32743ef2ef248123b39354801631470,505,87,600,1,1193,Crawford361565da1fa79e975a662ad464f678b6d32743ef2ef248123b39354801631470
Crisp,361565da1fa79e975a662ad464f678b6d32743ef2ef248123b39354801631470,783,109,1352,1,2245,Crisp361565da1fa79e975a662ad464f678b6d32743ef2ef248123b39354801631470
Dade,361565da1fa79e975a662ad464f678b6d32743ef2ef248123b39354801631470,417,45,418,0,880,Dade361565da1fa79e975a662ad464f678b6d32743ef2ef248123b39354801631470
Dawson,361565da1fa79e975a662ad464f678b6d32743ef2ef248123b39354801631470,318,82,831,2,1233,Dawson361565da1fa79e975a662ad464f678b6d32743ef2ef248123b39354801631470
Decatur,361565da1fa79e975a662ad464f678b6d32743ef2ef248123b39354801631470,1521,223,1768,17,3529,Decatur361565da1fa79e975a662ad464f678b6d32743ef2ef248123b39354801631470
DeKalb,361565da1fa79e975a662ad464f678b6d32743ef2ef248123b39354801631470,77608,10163,130232,380,218383,DeKalb361565da1fa79e975a662ad464f678b6d32743ef2ef248123b39354801631470
Dodge,361565da1fa79e975a662ad464f678b6d32743ef2ef248123b39354801631470,745,92,604,0,1441,Dodge361565da1fa79e975a662ad464f678b6d32743ef2ef248123b39354801631470
Dooly,361565da1fa79e975a662ad464f678b6d32743ef2ef248123b39354801631470,788,90,554,9,1441,Dooly361565da1fa79e975a662ad464f678b6d32743ef2ef248123b39354801631470
Dougherty,361565da1fa79e975a662ad464f678b6d32743ef2ef248123b39354801631470,10463,963,8856,72,20354,Dougherty361565da1fa79e975a662ad464f678b6d32743ef2ef248123b39354801631470
Douglas,361565da1fa79e975a662ad464f678b6d32743ef2ef248123b39354801631470,9759,1049,17335,23,28166,Douglas361565da1fa79e975a662ad464f678b6d32743ef2ef248123b39354801631470
Early,361565da1fa79e975a662ad464f678b6d32743ef2ef248123b39354801631470,946,210,720,1,1877,Early361565da1fa79e975a662ad464f678b6d32743ef2ef248123b39354801631470
Echols,361565da1fa79e975a662ad464f678b6d32743ef2ef248123b39354801631470,68,2,76,0,146,Echols361565da1fa79e975a662ad464f678b6d32743ef2ef248123b39354801631470
Effingham,361565da1fa79e975a662ad464f678b6d32743ef2ef248123b39354801631470,1945,184,1920,0,4049,Effingham361565da1fa79e975a662ad464f678b6d32743ef2ef248123b39354801631470
Elbert,361565da1fa79e975a662ad464f678b6d32743ef2ef248123b39354801631470,773,183,1167,31,2154,Elbert361565da1fa79e975a662ad464f678b6d32743ef2ef248123b39354801631470
Emanuel,361565da1fa79e975a662ad464f678b6d32743ef2ef248123b39354801631470,1071,105,795,3,1974,Emanuel361565da1fa79e975a662ad464f678b6d32743ef2ef248123b39354801631470
Evans,361565da1fa79e975a662ad464f678b6d32743ef2ef248123b39354801631470,324,48,480,0,852,Evans361565da1fa79e975a662ad464f678b6d32743ef2ef248123b39354801631470
Fannin,361565da1fa79e975a662ad464f678b6d32743ef2ef248123b39354801631470,649,193,933,3,1778,Fannin361565da1fa79e975a662ad464f678b6d32743ef2ef248123b39354801631470
Fayette,361565da1fa79e975a662ad464f678b6d32743ef2ef248123b39354801631470,5595,982,13014,11,19602,Fayette361565da1fa79e975a662ad464f678b6d32743ef2ef248123b39354801631470
Floyd,361565da1fa79e975a662ad464f678b6d32743ef2ef248123b39354801631470,3132,439,4213,28,7812,Floyd361565da1fa79e975a662ad464f678b6d32743ef2ef248123b39354801631470
Forsyth,361565da1fa79e975a662ad464f678b6d32743ef2ef248123b39354801631470,4805,1005,12347,12,18169,Forsyth361565da1fa79e975a662ad464f678b6d32743ef2ef248123b39354801631470
Franklin,361565da1fa79e975a662ad464f678b6d32743ef2ef248123b39354801631470,605,62,446,0,1113,Franklin361565da1fa79e975a662ad464f678b6d32743ef2ef248123b39354801631470
Fulton,361565da1fa79e975a662ad464f678b6d32743ef2ef248123b39354801631470,85794,11631,148162,810,246397,Fulton361565da1fa79e975a662ad464f678b6d32743ef2ef248123b39354801631470
Gilmer,361565da1fa79e975a662ad464f678b6d32743ef2ef248123b39354801631470,688,125,979,3,1795,Gilmer361565da1fa79e975a662ad464f678b6d32743ef2ef248123b39354801631470
Glascock,361565da1fa79e975a662ad464f678b6d32743ef2ef248123b39354801631470,71,11,60,0,142,Glascock361565da1fa79e975a662ad464f678b6d32743ef2ef248123b39354801631470
Glynn,361565da1fa79e975a662ad464f678b6d32743ef2ef248123b39354801631470,3757,644,5013,25,9439,Glynn361565da1fa79e975a662ad464f678b6d32743ef2ef248123b39354801631470
Gordon,361565da1fa79e975a662ad464f678b6d32743ef2ef248123b39354801631470,1337,138,1374,5,2854,Gordon361565da1fa79e975a662ad464f678b6d32743ef2ef248123b39354801631470
Grady,361565da1fa79e975a662ad464f678b6d32743ef2ef248123b39354801631470,1090,102,1471,8,2671,Grady361565da1fa79e975a662ad464f678b6d32743ef2ef248123b39354801631470
Greene,361565da1fa79e975a662ad464f678b6d32743ef2ef248123b39354801631470,1010,350,1262,3,2625,Greene361565da1fa79e975a662ad464f678b6d32743ef2ef248123b39354801631470
Gwinnett,361565da1fa79e975a662ad464f678b6d32743ef2ef248123b39354801631470,64735,6343,69197,866,141141,Gwinnett361565da1fa79e975a662ad464f678b6d32743ef2ef248123b39354801631470
Habersham,361565da1fa79e975a662ad464f678b6d32743ef2ef248123b39354801631470,547,180,1446,0,2173,Habersham361565da1fa79e975a662ad464f678b6d32743ef2ef248123b39354801631470
Hall,361565da1fa79e975a662ad464f678b6d32743ef2ef248123b39354801631470,6026,891,6663,22,13602,Hall361565da1fa79e975a662ad464f678b6d32743ef2ef248123b39354801631470
Hancock,361565da1fa79e975a662ad464f678b6d32743ef2ef248123b39354801631470,1159,283,848,5,2295,Hancock361565da1fa79e975a662ad464f678b6d32743ef2ef248123b39354801631470
Haralson,361565da1fa79e975a662ad464f678b6d32743ef2ef248123b39354801631470,737,92,612,3,1444,Haralson361565da1fa79e975a662ad464f678b6d32743ef2ef248123b39354801631470
Harris,361565da1fa79e975a662ad464f678b6d32743ef2ef248123b39354801631470,1429,198,1768,0,3395,Harris361565da1fa79e975a662ad464f678b6d32743ef2ef248123b39354801631470
Hart,361565da1fa79e975a662ad464f678b6d32743ef2ef248123b39354801631470,870,158,1152,0,2180,Hart361565da1fa79e975a662ad464f678b6d32743ef2ef248123b39354801631470
Heard,361565da1fa79e975a662ad464f678b6d32743ef2ef248123b39354801631470,331,62,285,1,679,Heard361565da1fa79e975a662ad464f678b6d32743ef2ef248123b39354801631470
Henry,361565da1fa79e975a662ad464f678b6d32743ef2ef248123b39354801631470,12101,1525,30375,107,44108,Henry361565da1fa79e975a662ad464f678b6d32743ef2ef248123b39354801631470
Houston,361565da1fa79e975a662ad464f678b6d32743ef2ef248123b39354801631470,6364,978,11784,65,19191,Houston361565da1fa79e975a662ad464f678b6d32743ef2ef248123b39354801631470
Irwin,361565da1fa79e975a662ad464f678b6d32743ef2ef248123b39354801631470,347,39,376,0,762,Irwin361565da1fa79e975a662ad464f678b6d32743ef2ef248123b39354801631470
Jackson,361565da1fa79e975a662ad464f678b6d32743ef2ef248123b39354801631470,1438,138,2312,18,3906,Jackson361565da1fa79e975a662ad464f678b6d32743ef2ef248123b39354801631470
Jasper,361565da1fa79e975a662ad464f678b6d32743ef2ef248123b39354801631470,506,145,711,0,1362,Jasper361565da1fa79e975a662ad464f678b6d32743ef2ef248123b39354801631470
Jeff Davis,361565da1fa79e975a662ad464f678b6d32743ef2ef248123b39354801631470,400,38,337,0,775,Jeff Davis361565da1fa79e975a662ad464f678b6d32743ef2ef248123b39354801631470
Jefferson,361565da1fa79e975a662ad464f678b6d32743ef2ef248123b39354801631470,1604,313,1169,5,3091,Jefferson361565da1fa79e975a662ad464f678b6d32743ef2ef248123b39354801631470
Jenkins,361565da1fa79e975a662ad464f678b6d32743ef2ef248123b39354801631470,434,75,412,13,934,Jenkins361565da1fa79e975a662ad464f678b6d32743ef2ef248123b39354801631470
Johnson,361565da1fa79e975a662ad464f678b6d32743ef2ef248123b39354801631470,350,129,409,0,888,Johnson361565da1fa79e975a662ad464f678b6d32743ef2ef248123b39354801631470
Jones,361565da1fa79e975a662ad464f678b6d32743ef2ef248123b39354801631470,1234,299,1949,0,3482,Jones361565da1fa79e975a662ad464f678b6d32743ef2ef248123b39354801631470
Lamar,361565da1fa79e975a662ad464f678b6d32743ef2ef248123b39354801631470,773,135,1091,4,2003,Lamar361565da1fa79e975a662ad464f678b6d32743ef2ef248123b39354801631470
Lanier,361565da1fa79e975a662ad464f678b6d32743ef2ef248123b39354801631470,264,25,371,1,661,Lanier361565da1fa79e975a662ad464f678b6d32743ef2ef248123b39354801631470
Laurens,361565da1fa79e975a662ad464f678b6d32743ef2ef248123b39354801631470,2685,413,2464,1,5563,Laurens361565da1fa79e975a662ad464f678b6d32743ef2ef248123b39354801631470
Lee,361565da1fa79e975a662ad464f678b6d32743ef2ef248123b39354801631470,1320,153,1402,1,2876,Lee361565da1fa79e975a662ad464f678b6d32743ef2ef248123b39354801631470
Liberty,361565da1fa79e975a662ad464f678b6d32743ef2ef248123b39354801631470,2876,288,4957,26,8147,Liberty361565da1fa79e975a662ad464f678b6d32743ef2ef248123b39354801631470
Lincoln,361565da1fa79e975a662ad464f678b6d32743ef2ef248123b39354801631470,410,224,463,1,1098,Lincoln361565da1fa79e975a662ad464f678b6d32743ef2ef248123b39354801631470
Long,361565da1fa79e975a662ad464f678b6d32743ef2ef248123b39354801631470,522,39,588,3,1152,Long361565da1fa79e975a662ad464f678b6d32743ef2ef248123b39354801631470
Lowndes,361565da1fa79e975a662ad464f678b6d32743ef2ef248123b39354801631470,3853,631,8327,276,13087,Lowndes361565da1fa79e975a662ad464f678b6d32743ef2ef248123b39354801631470
Lumpkin,361565da1fa79e975a662ad464f678b6d32743ef2ef248123b39354801631470,443,127,1384,1,1955,Lumpkin361565da1fa79e975a662ad464f678b6d32743ef2ef248123b39354801631470
Macon,361565da1fa79e975a662ad464f678b6d32743ef2ef248123b39354801631470,1018,151,960,0,2129,Macon361565da1fa79e975a662ad464f678b6d32743ef2ef248123b39354801631470
Madison,361565da1fa79e975a662ad464f678b6d32743ef2ef248123b39354801631470,941,117,1106,0,2164,Madison361565da1fa79e975a662ad464f678b6d32743ef2ef248123b39354801631470
Marion,361565da1fa79e975a662ad464f678b6d32743ef2ef248123b39354801631470,421,172,440,0,1033,Marion361565da1fa79e975a662ad464f678b6d32743ef2ef248123b39354801631470
McDuffie,361565da1fa79e975a662ad464f678b6d32743ef2ef248123b39354801631470,1130,270,1645,0,3045,McDuffie361565da1fa79e975a662ad464f678b6d32743ef2ef248123b39354801631470
McIntosh,361565da1fa79e975a662ad464f678b6d32743ef2ef248123b39354801631470,795,199,907,4,1905,McIntosh361565da1fa79e975a662ad464f678b6d32743ef2ef248123b39354801631470
Meriwether,361565da1fa79e975a662ad464f678b6d32743ef2ef248123b39354801631470,1909,190,1092,3,3194,Meriwether361565da1fa79e975a662ad464f678b6d32743ef2ef248123b39354801631470
Miller,361565da1fa79e975a662ad464f678b6d32743ef2ef248123b39354801631470,293,44,165,1,503,Miller361565da1fa79e975a662ad464f678b6d32743ef2ef248123b39354801631470
Mitchell,361565da1fa79e975a662ad464f678b6d32743ef2ef248123b39354801631470,1248,353,1375,1,2977,Mitchell361565da1fa79e975a662ad464f678b6d32743ef2ef248123b39354801631470
Monroe,361565da1fa79e975a662ad464f678b6d32743ef2ef248123b39354801631470,1159,225,1580,1,2965,Monroe361565da1fa79e975a662ad464f678b6d32743ef2ef248123b39354801631470
Montgomery,361565da1fa79e975a662ad464f678b6d32743ef2ef248123b39354801631470,403,37,236,0,676,Montgomery361565da1fa79e975a662ad464f678b6d32743ef2ef248123b39354801631470
Morgan,361565da1fa79e975a662ad464f678b6d32743ef2ef248123b39354801631470,803,135,1275,3,2216,Morgan361565da1fa79e975a662ad464f678b6d32743ef2ef248123b39354801631470
Murray,361565da1fa79e975a662ad464f678b6d32743ef2ef248123b39354801631470,925,94,722,0,1741,Murray361565da1fa79e975a662ad464f678b6d32743ef2ef248123b39354801631470
Muscogee,361565da1fa79e975a662ad464f678b6d32743ef2ef248123b39354801631470,14112,1967,17460,81,33620,Muscogee361565da1fa79e975a662ad464f678b6d32743ef2ef248123b39354801631470
Newton,361565da1fa79e975a662ad464f678b6d32743ef2ef248123b39354801631470,8073,899,10877,2,19851,Newton361565da1fa79e975a662ad464f678b6d32743ef2ef248123b39354801631470
Oconee,361565da1fa79e975a662ad464f678b6d32743ef2ef248123b39354801631470,1459,258,2702,4,4423,Oconee361565da1fa79e975a662ad464f678b6d32743ef2ef248123b39354801631470
Oglethorpe,361565da1fa79e975a662ad464f678b6d32743ef2ef248123b39354801631470,626,80,922,1,1629,Oglethorpe361565da1fa79e975a662ad464f678b6d32743ef2ef248123b39354801631470
Paulding,361565da1fa79e975a662ad464f678b6d32743ef2ef248123b39354801631470,5000,773,9947,12,15732,Paulding361565da1fa79e975a662ad464f678b6d32743ef2ef248123b39354801631470
Peach,361565da1fa79e975a662ad464f678b6d32743ef2ef248123b39354801631470,1456,178,2803,17,4454,Peach361565da1fa79e975a662ad464f678b6d32743ef2ef248123b39354801631470
Pickens,361565da1fa79e975a662ad464f678b6d32743ef2ef248123b39354801631470,599,56,1082,2,1739,Pickens361565da1fa79e975a662ad464f678b6d32743ef2ef248123b39354801631470
Pierce,361565da1fa79e975a662ad464f678b6d32743ef2ef248123b39354801631470,238,50,463,0,751,Pierce361565da1fa79e975a662ad464f678b6d32743ef2ef248123b39354801631470
Pike,361565da1fa79e975a662ad464f678b6d32743ef2ef248123b39354801631470,419,69,613,0,1101,Pike361565da1fa79e975a662ad464f678b6d32743ef2ef248123b39354801631470
Polk,361565da1fa79e975a662ad464f678b6d32743ef2ef248123b39354801631470,925,117,1568,3,2613,Polk361565da1fa79e975a662ad464f678b6d32743ef2ef248123b39354801631470
Pulaski,361565da1fa79e975a662ad464f678b6d32743ef2ef248123b39354801631470,266,76,529,0,871,Pulaski361565da1fa79e975a662ad464f678b6d32743ef2ef248123b39354801631470
Putnam,361565da1fa79e975a662ad464f678b6d32743ef2ef248123b39354801631470,907,219,1207,1,2334,Putnam361565da1fa79e975a662ad464f678b6d32743ef2ef248123b39354801631470
Quitman,361565da1fa79e975a662ad464f678b6d32743ef2ef248123b39354801631470,204,17,161,0,382,Quitman361565da1fa79e975a662ad464f678b6d32743ef2ef248123b39354801631470
Rabun,361565da1fa79e975a662ad464f678b6d32743ef2ef248123b39354801631470,199,194,863,0,1256,Rabun361565da1fa79e975a662ad464f678b6d32743ef2ef248123b39354801631470
Randolph,361565da1fa79e975a662ad464f678b6d32743ef2ef248123b39354801631470,605,142,527,1,1275,Randolph361565da1fa79e975a662ad464f678b6d32743ef2ef248123b39354801631470
Richmond,361565da1fa79e975a662ad464f678b6d32743ef2ef248123b39354801631470,18674,2573,20906,76,42229,Richmond361565da1fa79e975a662ad464f678b6d32743ef2ef248123b39354801631470
Rockdale,361565da1fa79e975a662ad464f678b6d32743ef2ef248123b39354801631470,5730,715,14757,21,21223,Rockdale361565da1fa79e975a662ad464f678b6d32743ef2ef248123b39354801631470
Schley,361565da1fa79e975a662ad464f678b6d32743ef2ef248123b39354801631470,123,31,191,0,345,Schley361565da1fa79e975a662ad464f678b6d32743ef2ef248123b39354801631470
Screven,361565da1fa79e975a662ad464f678b6d32743ef2ef248123b39354801631470,1037,81,824,0,1942,Screven361565da1fa79e975a662ad464f678b6d32743ef2ef248123b39354801631470
Seminole,361565da1fa79e975a662ad464f678b6d32743ef2ef248123b39354801631470,593,50,366,3,1012,Seminole361565da1fa79e975a662ad464f678b6d32743ef2ef248123b39354801631470
Spalding,361565da1fa79e975a662ad464f678b6d32743ef2ef248123b39354801631470,3237,386,4249,7,7879,Spalding361565da1fa79e975a662ad464f678b6d32743ef2ef248123b39354801631470
Stephens,361565da1fa79e975a662ad464f678b6d32743ef2ef248123b39354801631470,400,133,1015,0,1548,Stephens361565da1fa79e975a662ad464f678b6d32743ef2ef248123b39354801631470
Stewart,361565da1fa79e975a662ad464f678b6d32743ef2ef248123b39354801631470,451,151,296,2,900,Stewart361565da1fa79e975a662ad464f678b6d32743ef2ef248123b39354801631470
Sumter,361565da1fa79e975a662ad464f678b6d32743ef2ef248123b39354801631470,1873,423,2580,0,4876,Sumter361565da1fa79e975a662ad464f678b6d32743ef2ef248123b39354801631470
Talbot,361565da1fa79e975a662ad464f678b6d32743ef2ef248123b39354801631470,889,372,378,0,1639,Talbot361565da1fa79e975a662ad464f678b6d32743ef2ef248123b39354801631470
Taliaferro,361565da1fa79e975a662ad464f678b6d32743ef2ef248123b39354801631470,180,77,185,1,443,Taliaferro361565da1fa79e975a662ad464f678b6d32743ef2ef248123b39354801631470
Tattnall,361565da1fa79e975a662ad464f678b6d32743ef2ef248123b39354801631470,573,94,684,3,1354,Tattnall361565da1fa79e975a662ad464f678b6d32743ef2ef248123b39354801631470
Taylor,361565da1fa79e975a662ad464f678b6d32743ef2ef248123b39354801631470,543,172,376,0,1091,Taylor361565da1fa79e975a662ad464f678b6d32743ef2ef248123b39354801631470
Telfair,361565da1fa79e975a662ad464f678b6d32743ef2ef248123b39354801631470,545,211,364,0,1120,Telfair361565da1fa79e975a662ad464f678b6d32743ef2ef248123b39354801631470
Terrell,361565da1fa79e975a662ad464f678b6d32743ef2ef248123b39354801631470,895,151,811,0,1857,Terrell361565da1fa79e975a662ad464f678b6d32743ef2ef248123b39354801631470
Thomas,361565da1fa79e975a662ad464f678b6d32743ef2ef248123b39354801631470,2371,358,3272,1,6002,Thomas361565da1fa79e975a662ad464f678b6d32743ef2ef248123b39354801631470
Tift,361565da1fa79e975a662ad464f678b6d32743ef2ef248123b39354801631470,1381,169,1876,6,3432,Tift361565da1fa79e975a662ad464f678b6d32743ef2ef248123b39354801631470
Toombs,361565da1fa79e975a662ad464f678b6d32743ef2ef248123b39354801631470,885,235,833,0,1953,Toombs361565da1fa79e975a662ad464f678b6d32743ef2ef248123b39354801631470
Towns,361565da1fa79e975a662ad464f678b6d32743ef2ef248123b39354801631470,297,92,774,1,1164,Towns361565da1fa79e975a662ad464f678b6d32743ef2ef248123b39354801631470
Treutlen,361565da1fa79e975a662ad464f678b6d32743ef2ef248123b39354801631470,227,47,350,2,626,Treutlen361565da1fa79e975a662ad464f678b6d32743ef2ef248123b39354801631470
Troup,361565da1fa79e975a662ad464f678b6d32743ef2ef248123b39354801631470,4134,471,3601,106,8312,Troup361565da1fa79e975a662ad464f678b6d32743ef2ef248123b39354801631470
Turner,361565da1fa79e975a662ad464f678b6d32743ef2ef248123b39354801631470,453,31,545,2,1031,Turner361565da1fa79e975a662ad464f678b6d32743ef2ef248123b39354801631470
Twiggs,361565da1fa79e975a662ad464f678b6d32743ef2ef248123b39354801631470,787,220,648,0,1655,Twiggs361565da1fa79e975a662ad464f678b6d32743ef2ef248123b39354801631470
Union,361565da1fa79e975a662ad464f678b6d32743ef2ef248123b39354801631470,538,154,1127,1,1820,Union361565da1fa79e975a662ad464f678b6d32743ef2ef248123b39354801631470
Upson,361565da1fa79e975a662ad464f678b6d32743ef2ef248123b39354801631470,1092,126,1689,4,2911,Upson361565da1fa79e975a662ad464f678b6d32743ef2ef248123b39354801631470
Walker,361565da1fa79e975a662ad464f678b6d32743ef2ef248123b39354801631470,1515,238,1996,1,3750,Walker361565da1fa79e975a662ad464f678b6d32743ef2ef248123b39354801631470
Walton,361565da1fa79e975a662ad464f678b6d32743ef2ef248123b39354801631470,3632,381,3162,8,7183,Walton361565da1fa79e975a662ad464f678b6d32743ef2ef248123b39354801631470
Ware,361565da1fa79e975a662ad464f678b6d32743ef2ef248123b39354801631470,874,197,1797,3,2871,Ware361565da1fa79e975a662ad464f678b6d32743ef2ef248123b39354801631470
Warren,361565da1fa79e975a662ad464f678b6d32743ef2ef248123b39354801631470,566,58,485,1,1110,Warren361565da1fa79e975a662ad464f678b6d32743ef2ef248123b39354801631470
Washington,361565da1fa79e975a662ad464f678b6d32743ef2ef248123b39354801631470,1568,417,1609,14,3608,Washington361565da1fa79e975a662ad464f678b6d32743ef2ef248123b39354801631470
Wayne,361565da1fa79e975a662ad464f678b6d32743ef2ef248123b39354801631470,677,85,942,1,1705,Wayne361565da1fa79e975a662ad464f678b6d32743ef2ef248123b39354801631470
Webster,361565da1fa79e975a662ad464f678b6d32743ef2ef248123b39354801631470,187,59,140,1,387,Webster361565da1fa79e975a662ad464f678b6d32743ef2ef248123b39354801631470
Wheeler,361565da1fa79e975a662ad464f678b6d32743ef2ef248123b39354801631470,260,58,227,0,545,Wheeler361565da1fa79e975a662ad464f678b6d32743ef2ef248123b39354801631470
White,361565da1fa79e975a662ad464f678b6d32743ef2ef248123b39354801631470,561,117,860,3,1541,White361565da1fa79e975a662ad464f678b6d32743ef2ef248123b39354801631470
Whitfield,361565da1fa79e975a662ad464f678b6d32743ef2ef248123b39354801631470,3566,345,2844,8,6763,Whitfield361565da1fa79e975a662ad464f678b6d32743ef2ef248123b39354801631470
Wilcox,361565da1fa79e975a662ad464f678b6d32743ef2ef248123b39354801631470,434,35,200,0,669,Wilcox361565da1fa79e975a662ad464f678b6d32743ef2ef248123b39354801631470
Wilkes,361565da1fa79e975a662ad464f678b6d32743ef2ef248123b39354801631470,795,87,641,2,1525,Wilkes361565da1fa79e975a662ad464f678b6d32743ef2ef248123b39354801631470
Wilkinson,361565da1fa79e975a662ad464f678b6d32743ef2ef248123b39354801631470,849,117,648,2,1616,Wilkinson361565da1fa79e975a662ad464f678b6d32743ef2ef248123b39354801631470
Worth,361565da1fa79e975a662ad464f678b6d32743ef2ef248123b39354801631470,921,95,819,4,1839,Worth361565da1fa79e975a662ad464f678b6d32743ef2ef248123b39354801631470
Appling,69098c7dc92c43f69ffb899ad095f0c14cda624ed50ed1e67361bb0c1e4d3d31,79,11,64,0,154,Appling69098c7dc92c43f69ffb899ad095f0c14cda624ed50ed1e67361bb0c1e4d3d31
Atkinson,69098c7dc92c43f69ffb899ad095f0c14cda624ed50ed1e67361bb0c1e4d3d31,37,1,27,0,65,Atkinson69098c7dc92c43f69ffb899ad095f0c14cda624ed50ed1e67361bb0c1e4d3d31
Bacon,69098c7dc92c43f69ffb899ad095f0c14cda624ed50ed1e67361bb0c1e4d3d31,38,2,55,0,95,Bacon69098c7dc92c43f69ffb899ad095f0c14cda624ed50ed1e67361bb0c1e4d3d31
Baker,69098c7dc92c43f69ffb899ad095f0c14cda624ed50ed1e67361bb0c1e4d3d31,16,3,10,0,29,Baker69098c7dc92c43f69ffb899ad095f0c14cda624ed50ed1e67361bb0c1e4d3d31
Baldwin,69098c7dc92c43f69ffb899ad095f0c14cda624ed50ed1e67361bb0c1e4d3d31,211,27,225,1,464,Baldwin69098c7dc92c43f69ffb899ad095f0c14cda624ed50ed1e67361bb0c1e4d3d31
Banks,69098c7dc92c43f69ffb899ad095f0c14cda624ed50ed1e67361bb0c1e4d3d31,172,17,115,0,304,Banks69098c7dc92c43f69ffb899ad095f0c14cda624ed50ed1e67361bb0c1e4d3d31
Barrow,69098c7dc92c43f69ffb899ad095f0c14cda624ed50ed1e67361bb0c1e4d3d31,853,42,713,0,1608,Barrow69098c7dc92c43f69ffb899ad095f0c14cda624ed50ed1e67361bb0c1e4d3d31
Bartow,69098c7dc92c43f69ffb899ad095f0c14cda624ed50ed1e67361bb0c1e4d3d31,1251,51,704,2,2008,Bartow69098c7dc92c43f69ffb899ad095f0c14cda624ed50ed1e67361bb0c1e4d3d31
Ben Hill,69098c7dc92c43f69ffb899ad095f0c14cda624ed50ed1e67361bb0c1e4d3d31,48,8,79,0,135,Ben Hill69098c7dc92c43f69ffb899ad095f0c14cda624ed50ed1e67361bb0c1e4d3d31
Berrien,69098c7dc92c43f69ffb899ad095f0c14cda624ed50ed1e67361bb0c1e4d3d31,92,17,117,0,226,Berrien69098c7dc92c43f69ffb899ad095f0c14cda624ed50ed1e67361bb0c1e4d3d31
Bibb,69098c7dc92c43f69ffb899ad095f0c14cda624ed50ed1e67361bb0c1e4d3d31,935,81,650,11,1677,Bibb69098c7dc92c43f69ffb899ad095f0c14cda624ed50ed1e67361bb0c1e4d3d31
Bleckley,69098c7dc92c43f69ffb899ad095f0c14cda624ed50ed1e67361bb0c1e4d3d31,58,8,81,0,147,Bleckley69098c7dc92c43f69ffb899ad095f0c14cda624ed50ed1e67361bb0c1e4d3d31
Brantley,69098c7dc92c43f69ffb899ad095f0c14cda624ed50ed1e67361bb0c1e4d3d31,139,8,97,0,244,Brantley69098c7dc92c43f69ffb899ad095f0c14cda624ed50ed1e67361bb0c1e4d3d31
Brooks,69098c7dc92c43f69ffb899ad095f0c14cda624ed50ed1e67361bb0c1e4d3d31,88,8,87,5,188,Brooks69098c7dc92c43f69ffb899ad095f0c14cda624ed50ed1e67361bb0c1e4d3d31
Bryan,69098c7dc92c43f69ffb899ad095f0c14cda624ed50ed1e67361bb0c1e4d3d31,284,31,339,1,655,Bryan69098c7dc92c43f69ffb899ad095f0c14cda624ed50ed1e67361bb0c1e4d3d31
Bulloch,69098c7dc92c43f69ffb899ad095f0c14cda624ed50ed1e67361bb0c1e4d3d31,489,41,486,0,1016,Bulloch69098c7dc92c43f69ffb899ad095f0c14cda624ed50ed1e67361bb0c1e4d3d31
Burke,69098c7dc92c43f69ffb899ad095f0c14cda624ed50ed1e67361bb0c1e4d3d31,114,15,71,0,200,Burke69098c7dc92c43f69ffb899ad095f0c14cda624ed50ed1e67361bb0c1e4d3d31
Butts,69098c7dc92c43f69ffb899ad095f0c14cda624ed50ed1e67361bb0c1e4d3d31,126,9,211,0,346,Butts69098c7dc92c43f69ffb899ad095f0c14cda624ed50ed1e67361bb0c1e4d3d31
Calhoun,69098c7dc92c43f69ffb899ad095f0c14cda624ed50ed1e67361bb0c1e4d3d31,20,1,9,0,30,Calhoun69098c7dc92c43f69ffb899ad095f0c14cda624ed50ed1e67361bb0c1e4d3d31
Camden,69098c7dc92c43f69ffb899ad095f0c14cda624ed50ed1e67361bb0c1e4d3d31,518,47,439,2,1006,Camden69098c7dc92c43f69ffb899ad095f0c14cda624ed50ed1e67361bb0c1e4d3d31
Candler,69098c7dc92c43f69ffb899ad095f0c14cda624ed50ed1e67361bb0c1e4d3d31,35,3,67,0,105,Candler69098c7dc92c43f69ffb899ad095f0c14cda624ed50ed1e67361bb0c1e4d3d31
Carroll,69098c7dc92c43f69ffb899ad095f0c14cda624ed50ed1e67361bb0c1e4d3d31,1014,70,909,4,1997,Carroll69098c7dc92c43f69ffb899ad095f0c14cda624ed50ed1e67361bb0c1e4d3d31
Catoosa,69098c7dc92c43f69ffb899ad095f0c14cda624ed50ed1e67361bb0c1e4d3d31,589,28,663,1,1281,Catoosa69098c7dc92c43f69ffb899ad095f0c14cda624ed50ed1e67361bb0c1e4d3d31
Charlton,69098c7dc92c43f69ffb899ad095f0c14cda624ed50ed1e67361bb0c1e4d3d31,63,9,68,1,141,Charlton69098c7dc92c43f69ffb899ad095f0c14cda624ed50ed1e67361bb0c1e4d3d31
Chatham,69098c7dc92c43f69ffb899ad095f0c14cda624ed50ed1e67361bb0c1e4d3d31,3038,153,881,6,4078,Chatham69098c7dc92c43f69ffb899ad095f0c14cda624ed50ed1e67361bb0c1e4d3d31
Chattahoochee,69098c7dc92c43f69ffb899ad095f0c14cda624ed50ed1e67361bb0c1e4d3d31,32,1,29,0,62,Chattahoochee69098c7dc92c43f69ffb899ad095f0c14cda624ed50ed1e67361bb0c1e4d3d31
Chattooga,69098c7dc92c43f69ffb899ad095f0c14cda624ed50ed1e67361bb0c1e4d3d31,163,5,126,1,295,Chattooga69098c7dc92c43f69ffb899ad095f0c14cda624ed50ed1e67361bb0c1e4d3d31
Cherokee,69098c7dc92c43f69ffb899ad095f0c14cda624ed50ed1e67361bb0c1e4d3d31,3286,289,2862,1,6438,Cherokee69098c7dc92c43f69ffb899ad095f0c14cda624ed50ed1e67361bb0c1e4d3d31
Clarke,69098c7dc92c43f69ffb899ad095f0c14cda624ed50ed1e67361bb0c1e4d3d31,1185,104,911,3,2203,Clarke69098c7dc92c43f69ffb899ad095f0c14cda624ed50ed1e67361bb0c1e4d3d31
Clay,69098c7dc92c43f69ffb899ad095f0c14cda624ed50ed1e67361bb0c1e4d3d31,9,3,11,0,23,Clay69098c7dc92c43f69ffb899ad095f0c14cda624ed50ed1e67361bb0c1e4d3d31
Clayton,69098c7dc92c43f69ffb899ad095f0c14cda624ed50ed1e67361bb0c1e4d3d31,1086,88,1247,7,2428,Clayton69098c7dc92c43f69ffb899ad095f0c14cda624ed50ed1e67361bb0c1e4d3d31
Clinch,69098c7dc92c43f69ffb899ad095f0c14cda624ed50ed1e67361bb0c1e4d3d31,40,3,33,0,76,Clinch69098c7dc92c43f69ffb899ad095f0c14cda624ed50ed1e67361bb0c1e4d3d31
Cobb,69098c7dc92c43f69ffb899ad095f0c14cda624ed50ed1e67361bb0c1e4d3d31,10350,1092,5441,72,16955,Cobb69098c7dc92c43f69ffb899ad095f0c14cda624ed50ed1e67361bb0c1e4d3d31
Coffee,69098c7dc92c43f69ffb899ad095f0c14cda624ed50ed1e67361bb0c1e4d3d31,142,8,211,0,361,Coffee69098c7dc92c43f69ffb899ad095f0c14cda624ed50ed1e67361bb0c1e4d3d31
Colquitt,69098c7dc92c43f69ffb899ad095f0c14cda624ed50ed1e67361bb0c1e4d3d31,176,15,146,0,337,Colquitt69098c7dc92c43f69ffb899ad095f0c14cda624ed50ed1e67361bb0c1e4d3d31
Columbia,69098c7dc92c43f69ffb899ad095f0c14cda624ed50ed1e67361bb0c1e4d3d31,1293,153,997,0,2443,Columbia69098c7dc92c43f69ffb899ad095f0c14cda624ed50ed1e67361bb0c1e4d3d31
Cook,69098c7dc92c43f69ffb899ad095f0c14cda624ed50ed1e67361bb0c1e4d3d31,82,4,101,0,187,Cook69098c7dc92c43f69ffb899ad095f0c14cda624ed50ed1e67361bb0c1e4d3d31
Coweta,69098c7dc92c43f69ffb899ad095f0c14cda624ed50ed1e67361bb0c1e4d3d31,1436,136,1240,3,2815,Coweta69098c7dc92c43f69ffb899ad095f0c14cda624ed50ed1e67361bb0c1e4d3d31
Crawford,69098c7dc92c43f69ffb899ad095f0c14cda624ed50ed1e67361bb0c1e4d3d31,84,3,75,0,162,Crawford69098c7dc92c43f69ffb899ad095f0c14cda624ed50ed1e67361bb0c1e4d3d31
Crisp,69098c7dc92c43f69ffb899ad095f0c14cda624ed50ed1e67361bb0c1e4d3d31,67,5,98,1,171,Crisp69098c7dc92c43f69ffb899ad095f0c14cda624ed50ed1e67361bb0c1e4d3d31
Dade,69098c7dc92c43f69ffb899ad095f0c14cda624ed50ed1e67361bb0c1e4d3d31,196,5,146,0,347,Dade69098c7dc92c43f69ffb899ad095f0c14cda624ed50ed1e67361bb0c1e4d3d31
Dawson,69098c7dc92c43f69ffb899ad095f0c14cda624ed50ed1e67361bb0c1e4d3d31,230,27,401,1,659,Dawson69098c7dc92c43f69ffb899ad095f0c14cda624ed50ed1e67361bb0c1e4d3d31
Decatur,69098c7dc92c43f69ffb899ad095f0c14cda624ed50ed1e67361bb0c1e4d3d31,148,8,130,3,289,Decatur69098c7dc92c43f69ffb899ad095f0c14cda624ed50ed1e67361bb0c1e4d3d31
DeKalb,69098c7dc92c43f69ffb899ad095f0c14cda624ed50ed1e67361bb0c1e4d3d31,5897,560,5272,32,11761,DeKalb69098c7dc92c43f69ffb899ad095f0c14cda624ed50ed1e67361bb0c1e4d3d31
Dodge,69098c7dc92c43f69ffb899ad095f0c14cda624ed50ed1e67361bb0c1e4d3d31,85,6,81,0,172,Dodge69098c7dc92c43f69ffb899ad095f0c14cda624ed50ed1e67361bb0c1e4d3d31
Dooly,69098c7dc92c43f69ffb899ad095f0c14cda624ed50ed1e67361bb0c1e4d3d31,38,1,30,1,70,Dooly69098c7dc92c43f69ffb899ad095f0c14cda624ed50ed1e67361bb0c1e4d3d31
Dougherty,69098c7dc92c43f69ffb899ad095f0c14cda624ed50ed1e67361bb0c1e4d3d31,351,30,177,3,561,Dougherty69098c7dc92c43f69ffb899ad095f0c14cda624ed50ed1e67361bb0c1e4d3d31
Douglas,69098c7dc92c43f69ffb899ad095f0c14cda624ed50ed1e67361bb0c1e4d3d31,900,84,1082,2,2068,Douglas69098c7dc92c43f69ffb899ad095f0c14cda624ed50ed1e67361bb0c1e4d3d31
Early,69098c7dc92c43f69ffb899ad095f0c14cda624ed50ed1e67361bb0c1e4d3d31,63,9,40,0,112,Early69098c7dc92c43f69ffb899ad095f0c14cda624ed50ed1e67361bb0c1e4d3d31
Echols,69098c7dc92c43f69ffb899ad095f0c14cda624ed50ed1e67361bb0c1e4d3d31,22,1,22,0,45,Echols69098c7dc92c43f69ffb899ad095f0c14cda624ed50ed1e67361bb0c1e4d3d31
Effingham,69098c7dc92c43f69ffb899ad095f0c14cda624ed50ed1e67361bb0c1e4d3d31,502,42,319,0,863,Effingham69098c7dc92c43f69ffb899ad095f0c14cda624ed50ed1e67361bb0c1e4d3d31
Elbert,69098c7dc92c43f69ffb899ad095f0c14cda624ed50ed1e67361bb0c1e4d3d31,88,17,122,4,231,Elbert69098c7dc92c43f69ffb899ad095f0c14cda624ed50ed1e67361bb0c1e4d3d31
Emanuel,69098c7dc92c43f69ffb899ad095f0c14cda624ed50ed1e67361bb0c1e4d3d31,102,7,77,0,186,Emanuel69098c7dc92c43f69ffb899ad095f0c14cda624ed50ed1e67361bb0c1e4d3d31
Evans,69098c7dc92c43f69ffb899ad095f0c14cda624ed50ed1e67361bb0c1e4d3d31,36,6,38,0,80,Evans69098c7dc92c43f69ffb899ad095f0c14cda624ed50ed1e67361bb0c1e4d3d31
Fannin,69098c7dc92c43f69ffb899ad095f0c14cda624ed50ed1e67361bb0c1e4d3d31,209,43,210,0,462,Fannin69098c7dc92c43f69ffb899ad095f0c14cda624ed50ed1e67361bb0c1e4d3d31
Fayette,69098c7dc92c43f69ffb899ad095f0c14cda624ed50ed1e67361bb0c1e4d3d31,1022,126,1397,4,2549,Fayette69098c7dc92c43f69ffb899ad095f0c14cda624ed50ed1e67361bb0c1e4d3d31
Floyd,69098c7dc92c43f69ffb899ad095f0c14cda624ed50ed1e67361bb0c1e4d3d31,666,58,592,7,1323,Floyd69098c7dc92c43f69ffb899ad095f0c14cda624ed50ed1e67361bb0c1e4d3d31
Forsyth,69098c7dc92c43f69ffb899ad095f0c14cda624ed50ed1e67361bb0c1e4d3d31,1815,257,3183,3,5258,Forsyth69098c7dc92c43f69ffb899ad095f0c14cda624ed50ed1e67361bb0c1e4d3d31
Franklin,69098c7dc92c43f69ffb899ad095f0c14cda624ed50ed1e67361bb0c1e4d3d31,190,11,126,0,327,Franklin69098c7dc92c43f69ffb899ad095f0c14cda624ed50ed1e67361bb0c1e4d3d31
Fulton,69098c7dc92c43f69ffb899ad095f0c14cda624ed50ed1e67361bb0c1e4d3d31,7925,787,8628,81,17421,Fulton69098c7dc92c43f69ffb899ad095f0c14cda624ed50ed1e67361bb0c1e4d3d31
Gilmer,69098c7dc92c43f69ffb899ad095f0c14cda624ed50ed1e67361bb0c1e4d3d31,277,26,308,3,614,Gilmer69098c7dc92c43f69ffb899ad095f0c14cda624ed50ed1e67361bb0c1e4d3d31
Glascock,69098c7dc92c43f69ffb899ad095f0c14cda624ed50ed1e67361bb0c1e4d3d31,19,3,15,0,37,Glascock69098c7dc92c43f69ffb899ad095f0c14cda624ed50ed1e67361bb0c1e4d3d31
Glynn,69098c7dc92c43f69ffb899ad095f0c14cda624ed50ed1e67361bb0c1e4d3d31,617,49,500,3,1169,Glynn69098c7dc92c43f69ffb899ad095f0c14cda624ed50ed1e67361bb0c1e4d3d31
Gordon,69098c7dc92c43f69ffb899ad095f0c14cda624ed50ed1e67361bb0c1e4d3d31,448,22,344,2,816,Gordon69098c7dc92c43f69ffb899ad095f0c14cda624ed50ed1e67361bb0c1e4d3d31
Grady,69098c7dc92c43f69ffb899ad095f0c14cda624ed50ed1e67361bb0c1e4d3d31,133,14,114,0,261,Grady69098c7dc92c43f69ffb899ad095f0c14cda624ed50ed1e67361bb0c1e4d3d31
Greene,69098c7dc92c43f69ffb899ad095f0c14cda624ed50ed1e67361bb0c1e4d3d31,51,11,90,2,154,Greene69098c7dc92c43f69ffb899ad095f0c14cda624ed50ed1e67361bb0c1e4d3d31
Gwinnett,69098c7dc92c43f69ffb899ad095f0c14cda624ed50ed1e67361bb0c1e4d3d31,9061,821,5373,105,15360,Gwinnett69098c7dc92c43f69ffb899ad095f0c14cda624ed50ed1e67361bb0c1e4d3d31
Habersham,69098c7dc92c43f69ffb899ad095f0c14cda624ed50ed1e67361bb0c1e4d3d31,214,43,479,0,736,Habersham69098c7dc92c43f69ffb899ad095f0c14cda624ed50ed1e67361bb0c1e4d3d31
Hall,69098c7dc92c43f69ffb899ad095f0c14cda624ed50ed1e67361bb0c1e4d3d31,1888,179,1476,4,3547,Hall69098c7dc92c43f69ffb899ad095f0c14cda624ed50ed1e67361bb0c1e4d3d31
Hancock,69098c7dc92c43f69ffb899ad095f0c14cda624ed50ed1e67361bb0c1e4d3d31,28,6,22,0,56,Hancock69098c7dc92c43f69ffb899ad095f0c14cda624ed50ed1e67361bb0c1e4d3d31
Haralson,69098c7dc92c43f69ffb899ad095f0c14cda624ed50ed1e67361bb0c1e4d3d31,269,15,197,0,481,Haralson69098c7dc92c43f69ffb899ad095f0c14cda624ed50ed1e67361bb0c1e4d3d31
Harris,69098c7dc92c43f69ffb899ad095f0c14cda624ed50ed1e67361bb0c1e4d3d31,297,31,254,0,582,Harris69098c7dc92c43f69ffb899ad095f0c14cda624ed50ed1e67361bb0c1e4d3d31
Hart,69098c7dc92c43f69ffb899ad095f0c14cda624ed50ed1e67361bb0c1e4d3d31,165,22,158,0,345,Hart69098c7dc92c43f69ffb899ad095f0c14cda624ed50ed1e67361bb0c1e4d3d31
Heard,69098c7dc92c43f69ffb899ad095f0c14cda624ed50ed1e67361bb0c1e4d3d31,98,16,58,0,172,Heard69098c7dc92c43f69ffb899ad095f0c14cda624ed50ed1e67361bb0c1e4d3d31
Henry,69098c7dc92c43f69ffb899ad095f0c14cda624ed50ed1e67361bb0c1e4d3d31,1303,136,2016,13,3468,Henry69098c7dc92c43f69ffb899ad095f0c14cda624ed50ed1e67361bb0c1e4d3d31
Houston,69098c7dc92c43f69ffb899ad095f0c14cda624ed50ed1e67361bb0c1e4d3d31,837,94,1124,8,2063,Houston69098c7dc92c43f69ffb899ad095f0c14cda624ed50ed1e67361bb0c1e4d3d31
Irwin,69098c7dc92c43f69ffb899ad095f0c14cda624ed50ed1e67361bb0c1e4d3d31,47,2,39,0,88,Irwin69098c7dc92c43f69ffb899ad095f0c14cda624ed50ed1e67361bb0c1e4d3d31
Jackson,69098c7dc92c43f69ffb899ad095f0c14cda624ed50ed1e67361bb0c1e4d3d31,533,28,654,2,1217,Jackson69098c7dc92c43f69ffb899ad095f0c14cda624ed50ed1e67361bb0c1e4d3d31
Jasper,69098c7dc92c43f69ffb899ad095f0c14cda624ed50ed1e67361bb0c1e4d3d31,106,12,111,1,230,Jasper69098c7dc92c43f69ffb899ad095f0c14cda624ed50ed1e67361bb0c1e4d3d31
Jeff Davis,69098c7dc92c43f69ffb899ad095f0c14cda624ed50ed1e67361bb0c1e4d3d31,70,6,68,0,144,Jeff Davis69098c7dc92c43f69ffb899ad095f0c14cda624ed50ed1e67361bb0c1e4d3d31
Jefferson,69098c7dc92c43f69ffb899ad095f0c14cda624ed50ed1e67361bb0c1e4d3d31,59,4,48,2,113,Jefferson69098c7dc92c43f69ffb899ad095f0c14cda624ed50ed1e67361bb0c1e4d3d31
Jenkins,69098c7dc92c43f69ffb899ad095f0c14cda624ed50ed1e67361bb0c1e4d3d31,33,4,24,0,61,Jenkins69098c7dc92c43f69ffb899ad095f0c14cda624ed50ed1e67361bb0c1e4d3d31
Johnson,69098c7dc92c43f69ffb899ad095f0c14cda624ed50ed1e67361bb0c1e4d3d31,44,2,30,0,76,Johnson69098c7dc92c43f69ffb899ad095f0c14cda624ed50ed1e67361bb0c1e4d3d31
Jones,69098c7dc92c43f69ffb899ad095f0c14cda624ed50ed1e67361bb0c1e4d3d31,157,14,173,0,344,Jones69098c7dc92c43f69ffb899ad095f0c14cda624ed50ed1e67361bb0c1e4d3d31
Lamar,69098c7dc92c43f69ffb899ad095f0c14cda624ed50ed1e67361bb0c1e4d3d31,110,10,130,0,250,Lamar69098c7dc92c43f69ffb899ad095f0c14cda624ed50ed1e67361bb0c1e4d3d31
Lanier,69098c7dc92c43f69ffb899ad095f0c14cda624ed50ed1e67361bb0c1e4d3d31,53,3,65,0,121,Lanier69098c7dc92c43f69ffb899ad095f0c14cda624ed50ed1e67361bb0c1e4d3d31
Laurens,69098c7dc92c43f69ffb899ad095f0c14cda624ed50ed1e67361bb0c1e4d3d31,212,24,194,0,430,Laurens69098c7dc92c43f69ffb899ad095f0c14cda624ed50ed1e67361bb0c1e4d3d31
Lee,69098c7dc92c43f69ffb899ad095f0c14cda624ed50ed1e67361bb0c1e4d3d31,188,11,130,0,329,Lee69098c7dc92c43f69ffb899ad095f0c14cda624ed50ed1e67361bb0c1e4d3d31
Liberty,69098c7dc92c43f69ffb899ad095f0c14cda624ed50ed1e67361bb0c1e4d3d31,306,19,247,2,574,Liberty69098c7dc92c43f69ffb899ad095f0c14cda624ed50ed1e67361bb0c1e4d3d31
Lincoln,69098c7dc92c43f69ffb899ad095f0c14cda624ed50ed1e67361bb0c1e4d3d31,47,6,42,0,95,Lincoln69098c7dc92c43f69ffb899ad095f0c14cda624ed50ed1e67361bb0c1e4d3d31
Long,69098c7dc92c43f69ffb899ad095f0c14cda624ed50ed1e67361bb0c1e4d3d31,104,3,62,0,169,Long69098c7dc92c43f69ffb899ad095f0c14cda624ed50ed1e67361bb0c1e4d3d31
Lowndes,69098c7dc92c43f69ffb899ad095f0c14cda624ed50ed1e67361bb0c1e4d3d31,553,51,696,37,1337,Lowndes69098c7dc92c43f69ffb899ad095f0c14cda624ed50ed1e67361bb0c1e4d3d31
Lumpkin,69098c7dc92c43f69ffb899ad095f0c14cda624ed50ed1e67361bb0c1e4d3d31,252,25,495,0,772,Lumpkin69098c7dc92c43f69ffb899ad095f0c14cda624ed50ed1e67361bb0c1e4d3d31
Macon,69098c7dc92c43f69ffb899ad095f0c14cda624ed50ed1e67361bb0c1e4d3d31,37,3,38,0,78,Macon69098c7dc92c43f69ffb899ad095f0c14cda624ed50ed1e67361bb0c1e4d3d31
Madison,69098c7dc92c43f69ffb899ad095f0c14cda624ed50ed1e67361bb0c1e4d3d31,229,23,189,0,441,Madison69098c7dc92c43f69ffb899ad095f0c14cda624ed50ed1e67361bb0c1e4d3d31
Marion,69098c7dc92c43f69ffb899ad095f0c14cda624ed50ed1e67361bb0c1e4d3d31,47,6,24,0,77,Marion69098c7dc92c43f69ffb899ad095f0c14cda624ed50ed1e67361bb0c1e4d3d31
McDuffie,69098c7dc92c43f69ffb899ad095f0c14cda624ed50ed1e67361bb0c1e4d3d31,91,16,104,0,211,McDuffie69098c7dc92c43f69ffb899ad095f0c14cda624ed50ed1e67361bb0c1e4d3d31
McIntosh,69098c7dc92c43f69ffb899ad095f0c14cda624ed50ed1e67361bb0c1e4d3d31,83,14,92,0,189,McIntosh69098c7dc92c43f69ffb899ad095f0c14cda624ed50ed1e67361bb0c1e4d3d31
Meriwether,69098c7dc92c43f69ffb899ad095f0c14cda624ed50ed1e67361bb0c1e4d3d31,165,6,100,1,272,Meriwether69098c7dc92c43f69ffb899ad095f0c14cda624ed50ed1e67361bb0c1e4d3d31
Miller,69098c7dc92c43f69ffb899ad095f0c14cda624ed50ed1e67361bb0c1e4d3d31,38,4,18,0,60,Miller69098c7dc92c43f69ffb899ad095f0c14cda624ed50ed1e67361bb0c1e4d3d31
Mitchell,69098c7dc92c43f69ffb899ad095f0c14cda624ed50ed1e67361bb0c1e4d3d31,64,7,56,0,127,Mitchell69098c7dc92c43f69ffb899ad095f0c14cda624ed50ed1e67361bb0c1e4d3d31
Monroe,69098c7dc92c43f69ffb899ad095f0c14cda624ed50ed1e67361bb0c1e4d3d31,207,18,159,1,385,Monroe69098c7dc92c43f69ffb899ad095f0c14cda624ed50ed1e67361bb0c1e4d3d31
Montgomery,69098c7dc92c43f69ffb899ad095f0c14cda624ed50ed1e67361bb0c1e4d3d31,57,0,36,0,93,Montgomery69098c7dc92c43f69ffb899ad095f0c14cda624ed50ed1e67361bb0c1e4d3d31
Morgan,69098c7dc92c43f69ffb899ad095f0c14cda624ed50ed1e67361bb0c1e4d3d31,133,13,173,0,319,Morgan69098c7dc92c43f69ffb899ad095f0c14cda624ed50ed1e67361bb0c1e4d3d31
Murray,69098c7dc92c43f69ffb899ad095f0c14cda624ed50ed1e67361bb0c1e4d3d31,255,16,182,0,453,Murray69098c7dc92c43f69ffb899ad095f0c14cda624ed50ed1e67361bb0c1e4d3d31
Muscogee,69098c7dc92c43f69ffb899ad095f0c14cda624ed50ed1e67361bb0c1e4d3d31,1315,95,840,4,2254,Muscogee69098c7dc92c43f69ffb899ad095f0c14cda624ed50ed1e67361bb0c1e4d3d31
Newton,69098c7dc92c43f69ffb899ad095f0c14cda624ed50ed1e67361bb0c1e4d3d31,805,49,547,0,1401,Newton69098c7dc92c43f69ffb899ad095f0c14cda624ed50ed1e67361bb0c1e4d3d31
Oconee,69098c7dc92c43f69ffb899ad095f0c14cda624ed50ed1e67361bb0c1e4d3d31,405,30,438,1,874,Oconee69098c7dc92c43f69ffb899ad095f0c14cda624ed50ed1e67361bb0c1e4d3d31
Oglethorpe,69098c7dc92c43f69ffb899ad095f0c14cda624ed50ed1e67361bb0c1e4d3d31,104,17,137,0,258,Oglethorpe69098c7dc92c43f69ffb899ad095f0c14cda624ed50ed1e67361bb0c1e4d3d31
Paulding,69098c7dc92c43f69ffb899ad095f0c14cda624ed50ed1e67361bb0c1e4d3d31,1197,153,1749,3,3102,Paulding69098c7dc92c43f69ffb899ad095f0c14cda624ed50ed1e67361bb0c1e4d3d31
Peach,69098c7dc92c43f69ffb899ad095f0c14cda624ed50ed1e67361bb0c1e4d3d31,124,11,188,0,323,Peach69098c7dc92c43f69ffb899ad095f0c14cda624ed50ed1e67361bb0c1e4d3d31
Pickens,69098c7dc92c43f69ffb899ad095f0c14cda624ed50ed1e67361bb0c1e4d3d31,302,10,361,0,673,Pickens69098c7dc92c43f69ffb899ad095f0c14cda624ed50ed1e67361bb0c1e4d3d31
Pierce,69098c7dc92c43f69ffb899ad095f0c14cda624ed50ed1e67361bb0c1e4d3d31,64,4,114,1,183,Pierce69098c7dc92c43f69ffb899ad095f0c14cda624ed50ed1e67361bb0c1e4d3d31
Pike,69098c7dc92c43f69ffb899ad095f0c14cda624ed50ed1e67361bb0c1e4d3d31,143,15,155,0,313,Pike69098c7dc92c43f69ffb899ad095f0c14cda624ed50ed1e67361bb0c1e4d3d31
Polk,69098c7dc92c43f69ffb899ad095f0c14cda624ed50ed1e67361bb0c1e4d3d31,208,17,294,0,519,Polk69098c7dc92c43f69ffb899ad095f0c14cda624ed50ed1e67361bb0c1e4d3d31
Pulaski,69098c7dc92c43f69ffb899ad095f0c14cda624ed50ed1e67361bb0c1e4d3d31,23,5,60,0,88,Pulaski69098c7dc92c43f69ffb899ad095f0c14cda624ed50ed1e67361bb0c1e4d3d31
Putnam,69098c7dc92c43f69ffb899ad095f0c14cda624ed50ed1e67361bb0c1e4d3d31,117,16,143,1,277,Putnam69098c7dc92c43f69ffb899ad095f0c14cda624ed50ed1e67361bb0c1e4d3d31
Quitman,69098c7dc92c43f69ffb899ad095f0c14cda624ed50ed1e67361bb0c1e4d3d31,15,1,13,0,29,Quitman69098c7dc92c43f69ffb899ad095f0c14cda624ed50ed1e67361bb0c1e4d3d31
Rabun,69098c7dc92c43f69ffb899ad095f0c14cda624ed50ed1e67361bb0c1e4d3d31,81,25,224,0,330,Rabun69098c7dc92c43f69ffb899ad095f0c14cda624ed50ed1e67361bb0c1e4d3d31
Randolph,69098c7dc92c43f69ffb899ad095f0c14cda624ed50ed1e67361bb0c1e4d3d31,20,2,19,0,41,Randolph69098c7dc92c43f69ffb899ad095f0c14cda624ed50ed1e67361bb0c1e4d3d31
Richmond,69098c7dc92c43f69ffb899ad095f0c14cda624ed50ed1e67361bb0c1e4d3d31,1276,111,799,10,2196,Richmond69098c7dc92c43f69ffb899ad095f0c14cda624ed50ed1e67361bb0c1e4d3d31
Rockdale,69098c7dc92c43f69ffb899ad095f0c14cda624ed50ed1e67361bb0c1e4d3d31,453,45,651,1,1150,Rockdale69098c7dc92c43f69ffb899ad095f0c14cda624ed50ed1e67361bb0c1e4d3d31
Schley,69098c7dc92c43f69ffb899ad095f0c14cda624ed50ed1e67361bb0c1e4d3d31,15,2,21,0,38,Schley69098c7dc92c43f69ffb899ad095f0c14cda624ed50ed1e67361bb0c1e4d3d31
Screven,69098c7dc92c43f69ffb899ad095f0c14cda624ed50ed1e67361bb0c1e4d3d31,63,5,41,0,109,Screven69098c7dc92c43f69ffb899ad095f0c14cda624ed50ed1e67361bb0c1e4d3d31
Seminole,69098c7dc92c43f69ffb899ad095f0c14cda624ed50ed1e67361bb0c1e4d3d31,54,7,28,1,90,Seminole69098c7dc92c43f69ffb899ad095f0c14cda624ed50ed1e67361bb0c1e4d3d31
Spalding,69098c7dc92c43f69ffb899ad095f0c14cda624ed50ed1e67361bb0c1e4d3d31,436,33,443,2,914,Spalding69098c7dc92c43f69ffb899ad095f0c14cda624ed50ed1e67361bb0c1e4d3d31
Stephens,69098c7dc92c43f69ffb899ad095f0c14cda624ed50ed1e67361bb0c1e4d3d31,99,21,226,0,346,Stephens69098c7dc92c43f69ffb899ad095f0c14cda624ed50ed1e67361bb0c1e4d3d31
Stewart,69098c7dc92c43f69ffb899ad095f0c14cda624ed50ed1e67361bb0c1e4d3d31,19,9,15,0,43,Stewart69098c7dc92c43f69ffb899ad095f0c14cda624ed50ed1e67361bb0c1e4d3d31
Sumter,69098c7dc92c43f69ffb899ad095f0c14cda624ed50ed1e67361bb0c1e4d3d31,88,13,96,0,197,Sumter69098c7dc92c43f69ffb899ad095f0c14cda624ed50ed1e67361bb0c1e4d3d31
Talbot,69098c7dc92c43f69ffb899ad095f0c14cda624ed50ed1e67361bb0c1e4d3d31,63,19,15,0,97,Talbot69098c7dc92c43f69ffb899ad095f0c14cda624ed50ed1e67361bb0c1e4d3d31
Taliaferro,69098c7dc92c43f69ffb899ad095f0c14cda624ed50ed1e67361bb0c1e4d3d31,5,3,6,0,14,Taliaferro69098c7dc92c43f69ffb899ad095f0c14cda624ed50ed1e67361bb0c1e4d3d31
Tattnall,69098c7dc92c43f69ffb899ad095f0c14cda624ed50ed1e67361bb0c1e4d3d31,70,16,61,0,147,Tattnall69098c7dc92c43f69ffb899ad095f0c14cda624ed50ed1e67361bb0c1e4d3d31
Taylor,69098c7dc92c43f69ffb899ad095f0c14cda624ed50ed1e67361bb0c1e4d3d31,36,7,38,0,81,Taylor69098c7dc92c43f69ffb899ad095f0c14cda624ed50ed1e67361bb0c1e4d3d31
Telfair,69098c7dc92c43f69ffb899ad095f0c14cda624ed50ed1e67361bb0c1e4d3d31,31,3,25,0,59,Telfair69098c7dc92c43f69ffb899ad095f0c14cda624ed50ed1e67361bb0c1e4d3d31
Terrell,69098c7dc92c43f69ffb899ad095f0c14cda624ed50ed1e67361bb0c1e4d3d31,46,3,29,0,78,Terrell69098c7dc92c43f69ffb899ad095f0c14cda624ed50ed1e67361bb0c1e4d3d31
Thomas,69098c7dc92c43f69ffb899ad095f0c14cda624ed50ed1e67361bb0c1e4d3d31,246,23,257,0,526,Thomas69098c7dc92c43f69ffb899ad095f0c14cda624ed50ed1e67361bb0c1e4d3d31
Tift,69098c7dc92c43f69ffb899ad095f0c14cda624ed50ed1e67361bb0c1e4d3d31,176,20,162,0,358,Tift69098c7dc92c43f69ffb899ad095f0c14cda624ed50ed1e67361bb0c1e4d3d31
Toombs,69098c7dc92c43f69ffb899ad095f0c14cda624ed50ed1e67361bb0c1e4d3d31,110,18,120,0,248,Toombs69098c7dc92c43f69ffb899ad095f0c14cda624ed50ed1e67361bb0c1e4d3d31
Towns,69098c7dc92c43f69ffb899ad095f0c14cda624ed50ed1e67361bb0c1e4d3d31,80,13,130,3,226,Towns69098c7dc92c43f69ffb899ad095f0c14cda624ed50ed1e67361bb0c1e4d3d31
Treutlen,69098c7dc92c43f69ffb899ad095f0c14cda624ed50ed1e67361bb0c1e4d3d31,28,5,31,0,64,Treutlen69098c7dc92c43f69ffb899ad095f0c14cda624ed50ed1e67361bb0c1e4d3d31
Troup,69098c7dc92c43f69ffb899ad095f0c14cda624ed50ed1e67361bb0c1e4d3d31,445,28,349,8,830,Troup69098c7dc92c43f69ffb899ad095f0c14cda624ed50ed1e67361bb0c1e4d3d31
Turner,69098c7dc92c43f69ffb899ad095f0c14cda624ed50ed1e67361bb0c1e4d3d31,27,0,48,0,75,Turner69098c7dc92c43f69ffb899ad095f0c14cda624ed50ed1e67361bb0c1e4d3d31
Twiggs,69098c7dc92c43f69ffb899ad095f0c14cda624ed50ed1e67361bb0c1e4d3d31,57,6,32,0,95,Twiggs69098c7dc92c43f69ffb899ad095f0c14cda624ed50ed1e67361bb0c1e4d3d31
Union,69098c7dc92c43f69ffb899ad095f0c14cda624ed50ed1e67361bb0c1e4d3d31,183,19,229,1,432,Union69098c7dc92c43f69ffb899ad095f0c14cda624ed50ed1e67361bb0c1e4d3d31
Upson,69098c7dc92c43f69ffb899ad095f0c14cda624ed50ed1e67361bb0c1e4d3d31,106,13,189,0,308,Upson69098c7dc92c43f69ffb899ad095f0c14cda624ed50ed1e67361bb0c1e4d3d31
Walker,69098c7dc92c43f69ffb899ad095f0c14cda624ed50ed1e67361bb0c1e4d3d31,567,37,509,3,1116,Walker69098c7dc92c43f69ffb899ad095f0c14cda624ed50ed1e67361bb0c1e4d3d31
Walton,69098c7dc92c43f69ffb899ad095f0c14cda624ed50ed1e67361bb0c1e4d3d31,892,69,656,5,1622,Walton69098c7dc92c43f69ffb899ad095f0c14cda624ed50ed1e67361bb0c1e4d3d31
Ware,69098c7dc92c43f69ffb899ad095f0c14cda624ed50ed1e67361bb0c1e4d3d31,185,17,194,1,397,Ware69098c7dc92c43f69ffb899ad095f0c14cda624ed50ed1e67361bb0c1e4d3d31
Warren,69098c7dc92c43f69ffb899ad095f0c14cda624ed50ed1e67361bb0c1e4d3d31,16,4,25,0,45,Warren69098c7dc92c43f69ffb899ad095f0c14cda624ed50ed1e67361bb0c1e4d3d31
Washington,69098c7dc92c43f69ffb899ad095f0c14cda624ed50ed1e67361bb0c1e4d3d31,57,6,44,0,107,Washington69098c7dc92c43f69ffb899ad095f0c14cda624ed50ed1e67361bb0c1e4d3d31
Wayne,69098c7dc92c43f69ffb899ad095f0c14cda624ed50ed1e67361bb0c1e4d3d31,141,9,136,1,287,Wayne69098c7dc92c43f69ffb899ad095f0c14cda624ed50ed1e67361bb0c1e4d3d31
Webster,69098c7dc92c43f69ffb899ad095f0c14cda624ed50ed1e67361bb0c1e4d3d31,11,0,4,0,15,Webster69098c7dc92c43f69ffb899ad095f0c14cda624ed50ed1e67361bb0c1e4d3d31
Wheeler,69098c7dc92c43f69ffb899ad095f0c14cda624ed50ed1e67361bb0c1e4d3d31,29,1,25,0,55,Wheeler69098c7dc92c43f69ffb899ad095f0c14cda624ed50ed1e67361bb0c1e4d3d31
White,69098c7dc92c43f69ffb899ad095f0c14cda624ed50ed1e67361bb0c1e4d3d31,271,26,288,1,586,White69098c7dc92c43f69ffb899ad095f0c14cda624ed50ed1e67361bb0c1e4d3d31
Whitfield,69098c7dc92c43f69ffb899ad095f0c14cda624ed50ed1e67361bb0c1e4d3d31,841,52,487,1,1381,Whitfield69098c7dc92c43f69ffb899ad095f0c14cda624ed50ed1e67361bb0c1e4d3d31
Wilcox,69098c7dc92c43f69ffb899ad095f0c14cda624ed50ed1e67361bb0c1e4d3d31,39,5,26,0,70,Wilcox69098c7dc92c43f69ffb899ad095f0c14cda624ed50ed1e67361bb0c1e4d3d31
Wilkes,69098c7dc92c43f69ffb899ad095f0c14cda624ed50ed1e67361bb0c1e4d3d31,53,1,45,0,99,Wilkes69098c7dc92c43f69ffb899ad095f0c14cda624ed50ed1e67361bb0c1e4d3d31
Wilkinson,69098c7dc92c43f69ffb899ad095f0c14cda624ed50ed1e67361bb0c1e4d3d31,51,5,23,0,79,Wilkinson69098c7dc92c43f69ffb899ad095f0c14cda624ed50ed1e67361bb0c1e4d3d31
Worth,69098c7dc92c43f69ffb899ad095f0c14cda624ed50ed1e67361bb0c1e4d3d31,81,10,69,0,160,Worth69098c7dc92c43f69ffb899ad095f0c14cda624ed50ed1e67361bb0c1e4d3d31
Appling,9563b530805b8e59b46fe2492b228a3f93fe1ceae330ba98ca80ec18d3a8396e,2868,389,2161,2,5420,Appling9563b530805b8e59b46fe2492b228a3f93fe1ceae330ba98ca80ec18d3a8396e
Atkinson,9563b530805b8e59b46fe2492b228a3f93fe1ceae330ba98ca80ec18d3a8396e,800,70,906,1,1777,Atkinson9563b530805b8e59b46fe2492b228a3f93fe1ceae330ba98ca80ec18d3a8396e
Bacon,9563b530805b8e59b46fe2492b228a3f93fe1ceae330ba98ca80ec18d3a8396e,1066,139,1896,5,3106,Bacon9563b530805b8e59b46fe2492b228a3f93fe1ceae330ba98ca80ec18d3a8396e
Baker,9563b530805b8e59b46fe2492b228a3f93fe1ceae330ba98ca80ec18d3a8396e,412,92,312,0,816,Baker9563b530805b8e59b46fe2492b228a3f93fe1ceae330ba98ca80ec18d3a8396e
Baldwin,9563b530805b8e59b46fe2492b228a3f93fe1ceae330ba98ca80ec18d3a8396e,3341,433,5002,3,8779,Baldwin9563b530805b8e59b46fe2492b228a3f93fe1ceae330ba98ca80ec18d3a8396e
Banks,9563b530805b8e59b46fe2492b228a3f93fe1ceae330ba98ca80ec18d3a8396e,2947,185,2776,1,5909,Banks9563b530805b8e59b46fe2492b228a3f93fe1ceae330ba98ca80ec18d3a8396e
Barrow,9563b530805b8e59b46fe2492b228a3f93fe1ceae330ba98ca80ec18d3a8396e,9015,800,11157,1,20973,Barrow9563b530805b8e59b46fe2492b228a3f93fe1ceae330ba98ca80ec18d3a8396e
Bartow,9563b530805b8e59b46fe2492b228a3f93fe1ceae330ba98ca80ec18d3a8396e,15075,1094,13082,19,29270,Bartow9563b530805b8e59b46fe2492b228a3f93fe1ceae330ba98ca80ec18d3a8396e
Ben Hill,9563b530805b8e59b46fe2492b228a3f93fe1ceae330ba98ca80ec18d3a8396e,998,136,2738,5,3877,Ben Hill9563b530805b8e59b46fe2492b228a3f93fe1ceae330ba98ca80ec18d3a8396e
Berrien,9563b530805b8e59b46fe2492b228a3f93fe1ceae330ba98ca80ec18d3a8396e,2285,288,2691,11,5275,Berrien9563b530805b8e59b46fe2492b228a3f93fe1ceae330ba98ca80ec18d3a8396e
Bibb,9563b530805b8e59b46fe2492b228a3f93fe1ceae330ba98ca80ec18d3a8396e,15549,1919,13245,69,30782,Bibb9563b530805b8e59b46fe2492b228a3f93fe1ceae330ba98ca80ec18d3a8396e
Bleckley,9563b530805b8e59b46fe2492b228a3f93fe1ceae330ba98ca80ec18d3a8396e,1514,136,2054,4,3708,Bleckley9563b530805b8e59b46fe2492b228a3f93fe1ceae330ba98ca80ec18d3a8396e
Brantley,9563b530805b8e59b46fe2492b228a3f93fe1ceae330ba98ca80ec18d3a8396e,2264,190,2601,6,5061,Brantley9563b530805b8e59b46fe2492b228a3f93fe1ceae330ba98ca80ec18d3a8396e
Brooks,9563b530805b8e59b46fe2492b228a3f93fe1ceae330ba98ca80ec18d3a8396e,1840,224,1831,30,3925,Brooks9563b530805b8e59b46fe2492b228a3f93fe1ceae330ba98ca80ec18d3a8396e
Bryan,9563b530805b8e59b46fe2492b228a3f93fe1ceae330ba98ca80ec18d3a8396e,4084,325,6674,7,11090,Bryan9563b530805b8e59b46fe2492b228a3f93fe1ceae330ba98ca80ec18d3a8396e
Bulloch,9563b530805b8e59b46fe2492b228a3f93fe1ceae330ba98ca80ec18d3a8396e,8050,703,8165,35,16953,Bulloch9563b530805b8e59b46fe2492b228a3f93fe1ceae330ba98ca80ec18d3a8396e
Burke,9563b530805b8e59b46fe2492b228a3f93fe1ceae330ba98ca80ec18d3a8396e,2561,418,2223,0,5202,Burke9563b530805b8e59b46fe2492b228a3f93fe1ceae330ba98ca80ec18d3a8396e
Butts,9563b530805b8e59b46fe2492b228a3f93fe1ceae330ba98ca80ec18d3a8396e,1846,201,4819,0,6866,Butts9563b530805b8e59b46fe2492b228a3f93fe1ceae330ba98ca80ec18d3a8396e
Calhoun,9563b530805b8e59b46fe2492b228a3f93fe1ceae330ba98ca80ec18d3a8396e,545,66,376,1,988,Calhoun9563b530805b8e59b46fe2492b228a3f93fe1ceae330ba98ca80ec18d3a8396e
Camden,9563b530805b8e59b46fe2492b228a3f93fe1ceae330ba98ca80ec18d3a8396e,4962,716,7106,13,12797,Camden9563b530805b8e59b46fe2492b228a3f93fe1ceae330ba98ca80ec18d3a8396e
Candler,9563b530805b8e59b46fe2492b228a3f93fe1ceae330ba98ca80ec18d3a8396e,625,97,1959,3,2684,Candler9563b530805b8e59b46fe2492b228a3f93fe1ceae330ba98ca80ec18d3a8396e
Carroll,9563b530805b8e59b46fe2492b228a3f93fe1ceae330ba98ca80ec18d3a8396e,13437,1044,16766,55,31302,Carroll9563b530805b8e59b46fe2492b228a3f93fe1ceae330ba98ca80ec18d3a8396e
Catoosa,9563b530805b8e59b46fe2492b228a3f93fe1ceae330ba98ca80ec18d3a8396e,6758,496,13224,9,20487,Catoosa9563b530805b8e59b46fe2492b228a3f93fe1ceae330ba98ca80ec18d3a8396e
Charlton,9563b530805b8e59b46fe2492b228a3f93fe1ceae330ba98ca80ec18d3a8396e,1113,151,1475,7,2746,Charlton9563b530805b8e59b46fe2492b228a3f93fe1ceae330ba98ca80ec18d3a8396e
Chatham,9563b530805b8e59b46fe2492b228a3f93fe1ceae330ba98ca80ec18d3a8396e,38857,2711,18086,53,59707,Chatham9563b530805b8e59b46fe2492b228a3f93fe1ceae330ba98ca80ec18d3a8396e
Chattahoochee,9563b530805b8e59b46fe2492b228a3f93fe1ceae330ba98ca80ec18d3a8396e,416,28,304,6,754,Chattahoochee9563b530805b8e59b46fe2492b228a3f93fe1ceae330ba98ca80ec18d3a8396e
Chattooga,9563b530805b8e59b46fe2492b228a3f93fe1ceae330ba98ca80ec18d3a8396e,2953,159,3224,3,6339,Chattooga9563b530805b8e59b46fe2492b228a3f93fe1ceae330ba98ca80ec18d3a8396e
Cherokee,9563b530805b8e59b46fe2492b228a3f93fe1ceae330ba98ca80ec18d3a8396e,32534,3862,46090,16,82502,Cherokee9563b530805b8e59b46fe2492b228a3f93fe1ceae330ba98ca80ec18d3a8396e
Clarke,9563b530805b8e59b46fe2492b228a3f93fe1ceae330ba98ca80ec18d3a8396e,8794,1368,9810,34,20006,Clarke9563b530805b8e59b46fe2492b228a3f93fe1ceae330ba98ca80ec18d3a8396e
Clay,9563b530805b8e59b46fe2492b228a3f93fe1ceae330ba98ca80ec18d3a8396e,226,50,397,2,675,Clay9563b530805b8e59b46fe2492b228a3f93fe1ceae330ba98ca80ec18d3a8396e
Clayton,9563b530805b8e59b46fe2492b228a3f93fe1ceae330ba98ca80ec18d3a8396e,7822,1233,14291,38,23384,Clayton9563b530805b8e59b46fe2492b228a3f93fe1ceae330ba98ca80ec18d3a8396e
Clinch,9563b530805b8e59b46fe2492b228a3f93fe1ceae330ba98ca80ec18d3a8396e,679,64,949,3,1695,Clinch9563b530805b8e59b46fe2492b228a3f93fe1ceae330ba98ca80ec18d3a8396e
Cobb,9563b530805b8e59b46fe2492b228a3f93fe1ceae330ba98ca80ec18d3a8396e,97278,15208,74410,316,187212,Cobb9563b530805b8e59b46fe2492b228a3f93fe1ceae330ba98ca80ec18d3a8396e
Coffee,9563b530805b8e59b46fe2492b228a3f93fe1ceae330ba98ca80ec18d3a8396e,2994,321,6088,0,9403,Coffee9563b530805b8e59b46fe2492b228a3f93fe1ceae330ba98ca80ec18d3a8396e
Colquitt,9563b530805b8e59b46fe2492b228a3f93fe1ceae330ba98ca80ec18d3a8396e,4987,319,4668,5,9979,Colquitt9563b530805b8e59b46fe2492b228a3f93fe1ceae330ba98ca80ec18d3a8396e
Columbia,9563b530805b8e59b46fe2492b228a3f93fe1ceae330ba98ca80ec18d3a8396e,18912,2208,25966,20,47106,Columbia9563b530805b8e59b46fe2492b228a3f93fe1ceae330ba98ca80ec18d3a8396e
Cook,9563b530805b8e59b46fe2492b228a3f93fe1ceae330ba98ca80ec18d3a8396e,1692,162,2473,0,4327,Cook9563b530805b8e59b46fe2492b228a3f93fe1ceae330ba98ca80ec18d3a8396e
Coweta,9563b530805b8e59b46fe2492b228a3f93fe1ceae330ba98ca80ec18d3a8396e,19741,2132,22779,14,44666,Coweta9563b530805b8e59b46fe2492b228a3f93fe1ceae330ba98ca80ec18d3a8396e
Crawford,9563b530805b8e59b46fe2492b228a3f93fe1ceae330ba98ca80ec18d3a8396e,1601,174,1865,4,3644,Crawford9563b530805b8e59b46fe2492b228a3f93fe1ceae330ba98ca80ec18d3a8396e
Crisp,9563b530805b8e59b46fe2492b228a3f93fe1ceae330ba98ca80ec18d3a8396e,1476,246,3155,8,4885,Crisp9563b530805b8e59b46fe2492b228a3f93fe1ceae330ba98ca80ec18d3a8396e
Dade,9563b530805b8e59b46fe2492b228a3f93fe1ceae330ba98ca80ec18d3a8396e,2394,112,2174,2,4682,Dade9563b530805b8e59b46fe2492b228a3f93fe1ceae330ba98ca80ec18d3a8396e
Dawson,9563b530805b8e59b46fe2492b228a3f93fe1ceae330ba98ca80ec18d3a8396e,2346,408,6626,15,9395,Dawson9563b530805b8e59b46fe2492b228a3f93fe1ceae330ba98ca80ec18d3a8396e
Decatur,9563b530805b8e59b46fe2492b228a3f93fe1ceae330ba98ca80ec18d3a8396e,2356,328,3582,14,6280,Decatur9563b530805b8e59b46fe2492b228a3f93fe1ceae330ba98ca80ec18d3a8396e
DeKalb,9563b530805b8e59b46fe2492b228a3f93fe1ceae330ba98ca80ec18d3a8396e,41943,6822,54874,99,103738,DeKalb9563b530805b8e59b46fe2492b228a3f93fe1ceae330ba98ca80ec18d3a8396e
Dodge,9563b530805b8e59b46fe2492b228a3f93fe1ceae330ba98ca80ec18d3a8396e,2615,244,2027,0,4886,Dodge9563b530805b8e59b46fe2492b228a3f93fe1ceae330ba98ca80ec18d3a8396e
Dooly,9563b530805b8e59b46fe2492b228a3f93fe1ceae330ba98ca80ec18d3a8396e,904,89,1101,9,2103,Dooly9563b530805b8e59b46fe2492b228a3f93fe1ceae330ba98ca80ec18d3a8396e
Dougherty,9563b530805b8e59b46fe2492b228a3f93fe1ceae330ba98ca80ec18d3a8396e,7935,718,5672,25,14350,Dougherty9563b530805b8e59b46fe2492b228a3f93fe1ceae330ba98ca80ec18d3a8396e
Douglas,9563b530805b8e59b46fe2492b228a3f93fe1ceae330ba98ca80ec18d3a8396e,9394,1437,19101,18,29950,Douglas9563b530805b8e59b46fe2492b228a3f93fe1ceae330ba98ca80ec18d3a8396e
Early,9563b530805b8e59b46fe2492b228a3f93fe1ceae330ba98ca80ec18d3a8396e,1223,163,1417,0,2803,Early9563b530805b8e59b46fe2492b228a3f93fe1ceae330ba98ca80ec18d3a8396e
Echols,9563b530805b8e59b46fe2492b228a3f93fe1ceae330ba98ca80ec18d3a8396e,374,36,569,0,979,Echols9563b530805b8e59b46fe2492b228a3f93fe1ceae330ba98ca80ec18d3a8396e
Effingham,9563b530805b8e59b46fe2492b228a3f93fe1ceae330ba98ca80ec18d3a8396e,8255,475,9405,8,18143,Effingham9563b530805b8e59b46fe2492b228a3f93fe1ceae330ba98ca80ec18d3a8396e
Elbert,9563b530805b8e59b46fe2492b228a3f93fe1ceae330ba98ca80ec18d3a8396e,2066,331,3136,32,5565,Elbert9563b530805b8e59b46fe2492b228a3f93fe1ceae330ba98ca80ec18d3a8396e
Emanuel,9563b530805b8e59b46fe2492b228a3f93fe1ceae330ba98ca80ec18d3a8396e,2808,239,2330,7,5384,Emanuel9563b530805b8e59b46fe2492b228a3f93fe1ceae330ba98ca80ec18d3a8396e
Evans,9563b530805b8e59b46fe2492b228a3f93fe1ceae330ba98ca80ec18d3a8396e,728,130,1640,0,2498,Evans9563b530805b8e59b46fe2492b228a3f93fe1ceae330ba98ca80ec18d3a8396e
Fannin,9563b530805b8e59b46fe2492b228a3f93fe1ceae330ba98ca80ec18d3a8396e,3889,590,4428,4,8911,Fannin9563b530805b8e59b46fe2492b228a3f93fe1ceae330ba98ca80ec18d3a8396e
Fayette,9563b530805b8e59b46fe2492b228a3f93fe1ceae330ba98ca80ec18d3a8396e,12153,1915,25107,10,39185,Fayette9563b530805b8e59b46fe2492b228a3f93fe1ceae330ba98ca80ec18d3a8396e
Floyd,9563b530805b8e59b46fe2492b228a3f93fe1ceae330ba98ca80ec18d3a8396e,10314,921,13958,74,25267,Floyd9563b530805b8e59b46fe2492b228a3f93fe1ceae330ba98ca80ec18d3a8396e
Forsyth,9563b530805b8e59b46fe2492b228a3f93fe1ceae330ba98ca80ec18d3a8396e,18827,2930,52505,29,74291,Forsyth9563b530805b8e59b46fe2492b228a3f93fe1ceae330ba98ca80ec18d3a8396e
Franklin,9563b530805b8e59b46fe2492b228a3f93fe1ceae330ba98ca80ec18d3a8396e,3238,332,3268,0,6838,Franklin9563b530805b8e59b46fe2492b228a3f93fe1ceae330ba98ca80ec18d3a8396e
Fulton,9563b530805b8e59b46fe2492b228a3f93fe1ceae330ba98ca80ec18d3a8396e,64924,11151,111270,334,187679,Fulton9563b530805b8e59b46fe2492b228a3f93fe1ceae330ba98ca80ec18d3a8396e
Gilmer,9563b530805b8e59b46fe2492b228a3f93fe1ceae330ba98ca80ec18d3a8396e,3970,499,5029,6,9504,Gilmer9563b530805b8e59b46fe2492b228a3f93fe1ceae330ba98ca80ec18d3a8396e
Glascock,9563b530805b8e59b46fe2492b228a3f93fe1ceae330ba98ca80ec18d3a8396e,466,52,558,0,1076,Glascock9563b530805b8e59b46fe2492b228a3f93fe1ceae330ba98ca80ec18d3a8396e
Glynn,9563b530805b8e59b46fe2492b228a3f93fe1ceae330ba98ca80ec18d3a8396e,9534,945,12494,32,23005,Glynn9563b530805b8e59b46fe2492b228a3f93fe1ceae330ba98ca80ec18d3a8396e
Gordon,9563b530805b8e59b46fe2492b228a3f93fe1ceae330ba98ca80ec18d3a8396e,6733,450,7047,15,14245,Gordon9563b530805b8e59b46fe2492b228a3f93fe1ceae330ba98ca80ec18d3a8396e
Grady,9563b530805b8e59b46fe2492b228a3f93fe1ceae330ba98ca80ec18d3a8396e,2665,185,3342,6,6198,Grady9563b530805b8e59b46fe2492b228a3f93fe1ceae330ba98ca80ec18d3a8396e
Greene,9563b530805b8e59b46fe2492b228a3f93fe1ceae330ba98ca80ec18d3a8396e,1645,340,4173,3,6161,Greene9563b530805b8e59b46fe2492b228a3f93fe1ceae330ba98ca80ec18d3a8396e
Gwinnett,9563b530805b8e59b46fe2492b228a3f93fe1ceae330ba98ca80ec18d3a8396e,86747,12220,76816,599,176382,Gwinnett9563b530805b8e59b46fe2492b228a3f93fe1ceae330ba98ca80ec18d3a8396e
Habersham,9563b530805b8e59b46fe2492b228a3f93fe1ceae330ba98ca80ec18d3a8396e,2548,768,9650,2,12968,Habersham9563b530805b8e59b46fe2492b228a3f93fe1ceae330ba98ca80ec18d3a8396e
Hall,9563b530805b8e59b46fe2492b228a3f93fe1ceae330ba98ca80ec18d3a8396e,24689,2669,26542,44,53944,Hall9563b530805b8e59b46fe2492b228a3f93fe1ceae330ba98ca80ec18d3a8396e
Hancock,9563b530805b8e59b46fe2492b228a3f93fe1ceae330ba98ca80ec18d3a8396e,553,99,534,5,1191,Hancock9563b530805b8e59b46fe2492b228a3f93fe1ceae330ba98ca80ec18d3a8396e
Haralson,9563b530805b8e59b46fe2492b228a3f93fe1ceae330ba98ca80ec18d3a8396e,4531,351,4305,6,9193,Haralson9563b530805b8e59b46fe2492b228a3f93fe1ceae330ba98ca80ec18d3a8396e
Harris,9563b530805b8e59b46fe2492b228a3f93fe1ceae330ba98ca80ec18d3a8396e,5207,505,6650,1,12363,Harris9563b530805b8e59b46fe2492b228a3f93fe1ceae330ba98ca80ec18d3a8396e
Hart,9563b530805b8e59b46fe2492b228a3f93fe1ceae330ba98ca80ec18d3a8396e,3047,323,3888,0,7258,Hart9563b530805b8e59b46fe2492b228a3f93fe1ceae330ba98ca80ec18d3a8396e
Heard,9563b530805b8e59b46fe2492b228a3f93fe1ceae330ba98ca80ec18d3a8396e,1777,196,1294,1,3268,Heard9563b530805b8e59b46fe2492b228a3f93fe1ceae330ba98ca80ec18d3a8396e
Henry,9563b530805b8e59b46fe2492b228a3f93fe1ceae330ba98ca80ec18d3a8396e,13647,2119,36644,83,52493,Henry9563b530805b8e59b46fe2492b228a3f93fe1ceae330ba98ca80ec18d3a8396e
Houston,9563b530805b8e59b46fe2492b228a3f93fe1ceae330ba98ca80ec18d3a8396e,11732,1708,25526,65,39031,Houston9563b530805b8e59b46fe2492b228a3f93fe1ceae330ba98ca80ec18d3a8396e
Irwin,9563b530805b8e59b46fe2492b228a3f93fe1ceae330ba98ca80ec18d3a8396e,1266,90,1326,5,2687,Irwin9563b530805b8e59b46fe2492b228a3f93fe1ceae330ba98ca80ec18d3a8396e
Jackson,9563b530805b8e59b46fe2492b228a3f93fe1ceae330ba98ca80ec18d3a8396e,7795,655,13334,29,21813,Jackson9563b530805b8e59b46fe2492b228a3f93fe1ceae330ba98ca80ec18d3a8396e
Jasper,9563b530805b8e59b46fe2492b228a3f93fe1ceae330ba98ca80ec18d3a8396e,1693,230,2428,6,4357,Jasper9563b530805b8e59b46fe2492b228a3f93fe1ceae330ba98ca80ec18d3a8396e
Jeff Davis,9563b530805b8e59b46fe2492b228a3f93fe1ceae330ba98ca80ec18d3a8396e,1622,165,1944,2,3733,Jeff Davis9563b530805b8e59b46fe2492b228a3f93fe1ceae330ba98ca80ec18d3a8396e
Jefferson,9563b530805b8e59b46fe2492b228a3f93fe1ceae330ba98ca80ec18d3a8396e,1701,189,1540,6,3436,Jefferson9563b530805b8e59b46fe2492b228a3f93fe1ceae330ba98ca80ec18d3a8396e
Jenkins,9563b530805b8e59b46fe2492b228a3f93fe1ceae330ba98ca80ec18d3a8396e,778,110,1090,5,1983,Jenkins9563b530805b8e59b46fe2492b228a3f93fe1ceae330ba98ca80ec18d3a8396e
Johnson,9563b530805b8e59b46fe2492b228a3f93fe1ceae330ba98ca80ec18d3a8396e,935,148,1337,0,2420,Johnson9563b530805b8e59b46fe2492b228a3f93fe1ceae330ba98ca80ec18d3a8396e
Jones,9563b530805b8e59b46fe2492b228a3f93fe1ceae330ba98ca80ec18d3a8396e,3197,461,5083,1,8742,Jones9563b530805b8e59b46fe2492b228a3f93fe1ceae330ba98ca80ec18d3a8396e
Lamar,9563b530805b8e59b46fe2492b228a3f93fe1ceae330ba98ca80ec18d3a8396e,2050,230,2989,6,5275,Lamar9563b530805b8e59b46fe2492b228a3f93fe1ceae330ba98ca80ec18d3a8396e
Lanier,9563b530805b8e59b46fe2492b228a3f93fe1ceae330ba98ca80ec18d3a8396e,826,48,1159,1,2034,Lanier9563b530805b8e59b46fe2492b228a3f93fe1ceae330ba98ca80ec18d3a8396e
Laurens,9563b530805b8e59b46fe2492b228a3f93fe1ceae330ba98ca80ec18d3a8396e,6732,768,5670,2,13172,Laurens9563b530805b8e59b46fe2492b228a3f93fe1ceae330ba98ca80ec18d3a8396e
Lee,9563b530805b8e59b46fe2492b228a3f93fe1ceae330ba98ca80ec18d3a8396e,5083,359,5555,4,11001,Lee9563b530805b8e59b46fe2492b228a3f93fe1ceae330ba98ca80ec18d3a8396e
Liberty,9563b530805b8e59b46fe2492b228a3f93fe1ceae330ba98ca80ec18d3a8396e,3351,326,4194,15,7886,Liberty9563b530805b8e59b46fe2492b228a3f93fe1ceae330ba98ca80ec18d3a8396e
Lincoln,9563b530805b8e59b46fe2492b228a3f93fe1ceae330ba98ca80ec18d3a8396e,1115,169,1500,0,2784,Lincoln9563b530805b8e59b46fe2492b228a3f93fe1ceae330ba98ca80ec18d3a8396e
Long,9563b530805b8e59b46fe2492b228a3f93fe1ceae330ba98ca80ec18d3a8396e,1323,42,1293,3,2661,Long9563b530805b8e59b46fe2492b228a3f93fe1ceae330ba98ca80ec18d3a8396e
Lowndes,9563b530805b8e59b46fe2492b228a3f93fe1ceae330ba98ca80ec18d3a8396e,7221,948,15375,245,23789,Lowndes9563b530805b8e59b46fe2492b228a3f93fe1ceae330ba98ca80ec18d3a8396e
Lumpkin,9563b530805b8e59b46fe2492b228a3f93fe1ceae330ba98ca80ec18d3a8396e,2135,409,6872,5,9421,Lumpkin9563b530805b8e59b46fe2492b228a3f93fe1ceae330ba98ca80ec18d3a8396e
Macon,9563b530805b8e59b46fe2492b228a3f93fe1ceae330ba98ca80ec18d3a8396e,692,96,1054,0,1842,Macon9563b530805b8e59b46fe2492b228a3f93fe1ceae330ba98ca80ec18d3a8396e
Madison,9563b530805b8e59b46fe2492b228a3f93fe1ceae330ba98ca80ec18d3a8396e,4048,376,4747,6,9177,Madison9563b530805b8e59b46fe2492b228a3f93fe1ceae330ba98ca80ec18d3a8396e
Marion,9563b530805b8e59b46fe2492b228a3f93fe1ceae330ba98ca80ec18d3a8396e,1083,103,811,0,1997,Marion9563b530805b8e59b46fe2492b228a3f93fe1ceae330ba98ca80ec18d3a8396e
McDuffie,9563b530805b8e59b46fe2492b228a3f93fe1ceae330ba98ca80ec18d3a8396e,2100,335,3456,0,5891,McDuffie9563b530805b8e59b46fe2492b228a3f93fe1ceae330ba98ca80ec18d3a8396e
McIntosh,9563b530805b8e59b46fe2492b228a3f93fe1ceae330ba98ca80ec18d3a8396e,1349,406,1966,6,3727,McIntosh9563b530805b8e59b46fe2492b228a3f93fe1ceae330ba98ca80ec18d3a8396e
Meriwether,9563b530805b8e59b46fe2492b228a3f93fe1ceae330ba98ca80ec18d3a8396e,3268,247,2253,2,5770,Meriwether9563b530805b8e59b46fe2492b228a3f93fe1ceae330ba98ca80ec18d3a8396e
Miller,9563b530805b8e59b46fe2492b228a3f93fe1ceae330ba98ca80ec18d3a8396e,757,102,934,4,1797,Miller9563b530805b8e59b46fe2492b228a3f93fe1ceae330ba98ca80ec18d3a8396e
Mitchell,9563b530805b8e59b46fe2492b228a3f93fe1ceae330ba98ca80ec18d3a8396e,2231,264,2297,6,4798,Mitchell9563b530805b8e59b46fe2492b228a3f93fe1ceae330ba98ca80ec18d3a8396e
Monroe,9563b530805b8e59b46fe2492b228a3f93fe1ceae330ba98ca80ec18d3a8396e,4256,331,4576,7,9170,Monroe9563b530805b8e59b46fe2492b228a3f93fe1ceae330ba98ca80ec18d3a8396e
Montgomery,9563b530805b8e59b46fe2492b228a3f93fe1ceae330ba98ca80ec18d3a8396e,1536,92,961,0,2589,Montgomery9563b530805b8e59b46fe2492b228a3f93fe1ceae330ba98ca80ec18d3a8396e
Morgan,9563b530805b8e59b46fe2492b228a3f93fe1ceae330ba98ca80ec18d3a8396e,2577,266,4078,3,6924,Morgan9563b530805b8e59b46fe2492b228a3f93fe1ceae330ba98ca80ec18d3a8396e
Murray,9563b530805b8e59b46fe2492b228a3f93fe1ceae330ba98ca80ec18d3a8396e,4769,255,4299,0,9323,Murray9563b530805b8e59b46fe2492b228a3f93fe1ceae330ba98ca80ec18d3a8396e
Muscogee,9563b530805b8e59b46fe2492b228a3f93fe1ceae330ba98ca80ec18d3a8396e,15550,2135,15678,36,33399,Muscogee9563b530805b8e59b46fe2492b228a3f93fe1ceae330ba98ca80ec18d3a8396e
Newton,9563b530805b8e59b46fe2492b228a3f93fe1ceae330ba98ca80ec18d3a8396e,11339,1180,10740,2,23261,Newton9563b530805b8e59b46fe2492b228a3f93fe1ceae330ba98ca80ec18d3a8396e
Oconee,9563b530805b8e59b46fe2492b228a3f93fe1ceae330ba98ca80ec18d3a8396e,5791,640,8736,8,15175,Oconee9563b530805b8e59b46fe2492b228a3f93fe1ceae330ba98ca80ec18d3a8396e
Oglethorpe,9563b530805b8e59b46fe2492b228a3f93fe1ceae330ba98ca80ec18d3a8396e,1615,286,2862,1,4764,Oglethorpe9563b530805b8e59b46fe2492b228a3f93fe1ceae330ba98ca80ec18d3a8396e
Paulding,9563b530805b8e59b46fe2492b228a3f93fe1ceae330ba98ca80ec18d3a8396e,12478,2156,30183,12,44829,Paulding9563b530805b8e59b46fe2492b228a3f93fe1ceae330ba98ca80ec18d3a8396e
Peach,9563b530805b8e59b46fe2492b228a3f93fe1ceae330ba98ca80ec18d3a8396e,1741,207,4115,14,6077,Peach9563b530805b8e59b46fe2492b228a3f93fe1ceae330ba98ca80ec18d3a8396e
Pickens,9563b530805b8e59b46fe2492b228a3f93fe1ceae330ba98ca80ec18d3a8396e,4219,208,6529,0,10956,Pickens9563b530805b8e59b46fe2492b228a3f93fe1ceae330ba98ca80ec18d3a8396e
Pierce,9563b530805b8e59b46fe2492b228a3f93fe1ceae330ba98ca80ec18d3a8396e,1721,298,4138,1,6158,Pierce9563b530805b8e59b46fe2492b228a3f93fe1ceae330ba98ca80ec18d3a8396e
Pike,9563b530805b8e59b46fe2492b228a3f93fe1ceae330ba98ca80ec18d3a8396e,2573,293,4197,4,7067,Pike9563b530805b8e59b46fe2492b228a3f93fe1ceae330ba98ca80ec18d3a8396e
Polk,9563b530805b8e59b46fe2492b228a3f93fe1ceae330ba98ca80ec18d3a8396e,3294,345,6888,6,10533,Polk9563b530805b8e59b46fe2492b228a3f93fe1ceae330ba98ca80ec18d3a8396e
Pulaski,9563b530805b8e59b46fe2492b228a3f93fe1ceae330ba98ca80ec18d3a8396e,556,127,1822,1,2506,Pulaski9563b530805b8e59b46fe2492b228a3f93fe1ceae330ba98ca80ec18d3a8396e
Putnam,9563b530805b8e59b46fe2492b228a3f93fe1ceae330ba98ca80ec18d3a8396e,2428,421,3894,3,6746,Putnam9563b530805b8e59b46fe2492b228a3f93fe1ceae330ba98ca80ec18d3a8396e
Quitman,9563b530805b8e59b46fe2492b228a3f93fe1ceae330ba98ca80ec18d3a8396e,230,30,269,0,529,Quitman9563b530805b8e59b46fe2492b228a3f93fe1ceae330ba98ca80ec18d3a8396e
Rabun,9563b530805b8e59b46fe2492b228a3f93fe1ceae330ba98ca80ec18d3a8396e,1086,704,4406,0,6196,Rabun9563b530805b8e59b46fe2492b228a3f93fe1ceae330ba98ca80ec18d3a8396e
Randolph,9563b530805b8e59b46fe2492b228a3f93fe1ceae330ba98ca80ec18d3a8396e,755,58,638,1,1452,Randolph9563b530805b8e59b46fe2492b228a3f93fe1ceae330ba98ca80ec18d3a8396e
Richmond,9563b530805b8e59b46fe2492b228a3f93fe1ceae330ba98ca80ec18d3a8396e,16042,2210,15331,24,33607,Richmond9563b530805b8e59b46fe2492b228a3f93fe1ceae330ba98ca80ec18d3a8396e
Rockdale,9563b530805b8e59b46fe2492b228a3f93fe1ceae330ba98ca80ec18d3a8396e,4550,807,11617,10,16984,Rockdale9563b530805b8e59b46fe2492b228a3f93fe1ceae330ba98ca80ec18d3a8396e
Schley,9563b530805b8e59b46fe2492b228a3f93fe1ceae330ba98ca80ec18d3a8396e,430,57,965,0,1452,Schley9563b530805b8e59b46fe2492b228a3f93fe1ceae330ba98ca80ec18d3a8396e
Screven,9563b530805b8e59b46fe2492b228a3f93fe1ceae330ba98ca80ec18d3a8396e,1597,113,1773,0,3483,Screven9563b530805b8e59b46fe2492b228a3f93fe1ceae330ba98ca80ec18d3a8396e
Seminole,9563b530805b8e59b46fe2492b228a3f93fe1ceae330ba98ca80ec18d3a8396e,1285,125,932,2,2344,Seminole9563b530805b8e59b46fe2492b228a3f93fe1ceae330ba98ca80ec18d3a8396e
Spalding,9563b530805b8e59b46fe2492b228a3f93fe1ceae330ba98ca80ec18d3a8396e,5792,691,9701,8,16192,Spalding9563b530805b8e59b46fe2492b228a3f93fe1ceae330ba98ca80ec18d3a8396e
Stephens,9563b530805b8e59b46fe2492b228a3f93fe1ceae330ba98ca80ec18d3a8396e,1517,503,5701,3,7724,Stephens9563b530805b8e59b46fe2492b228a3f93fe1ceae330ba98ca80ec18d3a8396e
Stewart,9563b530805b8e59b46fe2492b228a3f93fe1ceae330ba98ca80ec18d3a8396e,341,145,337,3,826,Stewart9563b530805b8e59b46fe2492b228a3f93fe1ceae330ba98ca80ec18d3a8396e
Sumter,9563b530805b8e59b46fe2492b228a3f93fe1ceae330ba98ca80ec18d3a8396e,2615,356,3105,0,6076,Sumter9563b530805b8e59b46fe2492b228a3f93fe1ceae330ba98ca80ec18d3a8396e
Talbot,9563b530805b8e59b46fe2492b228a3f93fe1ceae330ba98ca80ec18d3a8396e,846,178,418,0,1442,Talbot9563b530805b8e59b46fe2492b228a3f93fe1ceae330ba98ca80ec18d3a8396e
Taliaferro,9563b530805b8e59b46fe2492b228a3f93fe1ceae330ba98ca80ec18d3a8396e,178,34,167,0,379,Taliaferro9563b530805b8e59b46fe2492b228a3f93fe1ceae330ba98ca80ec18d3a8396e
Tattnall,9563b530805b8e59b46fe2492b228a3f93fe1ceae330ba98ca80ec18d3a8396e,1897,443,2635,4,4979,Tattnall9563b530805b8e59b46fe2492b228a3f93fe1ceae330ba98ca80ec18d3a8396e
Taylor,9563b530805b8e59b46fe2492b228a3f93fe1ceae330ba98ca80ec18d3a8396e,746,139,1276,0,2161,Taylor9563b530805b8e59b46fe2492b228a3f93fe1ceae330ba98ca80ec18d3a8396e
Telfair,9563b530805b8e59b46fe2492b228a3f93fe1ceae330ba98ca80ec18d3a8396e,1271,120,962,1,2354,Telfair9563b530805b8e59b46fe2492b228a3f93fe1ceae330ba98ca80ec18d3a8396e
Terrell,9563b530805b8e59b46fe2492b228a3f93fe1ceae330ba98ca80ec18d3a8396e,1033,125,1066,2,2226,Terrell9563b530805b8e59b46fe2492b228a3f93fe1ceae330ba98ca80ec18d3a8396e
Thomas,9563b530805b8e59b46fe2492b228a3f93fe1ceae330ba98ca80ec18d3a8396e,4663,529,7075,5,12272,Thomas9563b530805b8e59b46fe2492b228a3f93fe1ceae330ba98ca80ec18d3a8396e
Tift,9563b530805b8e59b46fe2492b228a3f93fe1ceae330ba98ca80ec18d3a8396e,3757,387,5782,12,9938,Tift9563b530805b8e59b46fe2492b228a3f93fe1ceae330ba98ca80ec18d3a8396e
Toombs,9563b530805b8e59b46fe2492b228a3f93fe1ceae330ba98ca80ec18d3a8396e,2544,380,3619,2,6545,Toombs9563b530805b8e59b46fe2492b228a3f93fe1ceae330ba98ca80ec18d3a8396e
Towns,9563b530805b8e59b46fe2492b228a3f93fe1ceae330ba98ca80ec18d3a8396e,1347,296,3466,6,5115,Towns9563b530805b8e59b46fe2492b228a3f93fe1ceae330ba98ca80ec18d3a8396e
Treutlen,9563b530805b8e59b46fe2492b228a3f93fe1ceae330ba98ca80ec18d3a8396e,601,116,1063,3,1783,Treutlen9563b530805b8e59b46fe2492b228a3f93fe1ceae330ba98ca80ec18d3a8396e
Troup,9563b530805b8e59b46fe2492b228a3f93fe1ceae330ba98ca80ec18d3a8396e,7335,823,8665,124,16947,Troup9563b530805b8e59b46fe2492b228a3f93fe1ceae330ba98ca80ec18d3a8396e
Turner,9563b530805b8e59b46fe2492b228a3f93fe1ceae330ba98ca80ec18d3a8396e,678,58,1415,2,2153,Turner9563b530805b8e59b46fe2492b228a3f93fe1ceae330ba98ca80ec18d3a8396e
Twiggs,9563b530805b8e59b46fe2492b228a3f93fe1ceae330ba98ca80ec18d3a8396e,1157,117,817,1,2092,Twiggs9563b530805b8e59b46fe2492b228a3f93fe1ceae330ba98ca80ec18d3a8396e
Union,9563b530805b8e59b46fe2492b228a3f93fe1ceae330ba98ca80ec18d3a8396e,3099,480,5833,2,9414,Union9563b530805b8e59b46fe2492b228a3f93fe1ceae330ba98ca80ec18d3a8396e
Upson,9563b530805b8e59b46fe2492b228a3f93fe1ceae330ba98ca80ec18d3a8396e,1852,346,5290,3,7491,Upson9563b530805b8e59b46fe2492b228a3f93fe1ceae330ba98ca80ec18d3a8396e
Walker,9563b530805b8e59b46fe2492b228a3f93fe1ceae330ba98ca80ec18d3a8396e,7075,720,10423,6,18224,Walker9563b530805b8e59b46fe2492b228a3f93fe1ceae330ba98ca80ec18d3a8396e
Walton,9563b530805b8e59b46fe2492b228a3f93fe1ceae330ba98ca80ec18d3a8396e,15755,1292,13612,27,30686,Walton9563b530805b8e59b46fe2492b228a3f93fe1ceae330ba98ca80ec18d3a8396e
Ware,9563b530805b8e59b46fe2492b228a3f93fe1ceae330ba98ca80ec18d3a8396e,3648,400,4658,4,8710,Ware9563b530805b8e59b46fe2492b228a3f93fe1ceae330ba98ca80ec18d3a8396e
Warren,9563b530805b8e59b46fe2492b228a3f93fe1ceae330ba98ca80ec18d3a8396e,409,78,659,0,1146,Warren9563b530805b8e59b46fe2492b228a3f93fe1ceae330ba98ca80ec18d3a8396e
Washington,9563b530805b8e59b46fe2492b228a3f93fe1ceae330ba98ca80ec18d3a8396e,1922,340,2262,12,4536,Washington9563b530805b8e59b46fe2492b228a3f93fe1ceae330ba98ca80ec18d3a8396e
Wayne,9563b530805b8e59b46fe2492b228a3f93fe1ceae330ba98ca80ec18d3a8396e,3354,318,4334,7,8013,Wayne9563b530805b8e59b46fe2492b228a3f93fe1ceae330ba98ca80ec18d3a8396e
Webster,9563b530805b8e59b46fe2492b228a3f93fe1ceae330ba98ca80ec18d3a8396e,265,71,320,0,656,Webster9563b530805b8e59b46fe2492b228a3f93fe1ceae330ba98ca80ec18d3a8396e
Wheeler,9563b530805b8e59b46fe2492b228a3f93fe1ceae330ba98ca80ec18d3a8396e,670,104,641,3,1418,Wheeler9563b530805b8e59b46fe2492b228a3f93fe1ceae330ba98ca80ec18d3a8396e
White,9563b530805b8e59b46fe2492b228a3f93fe1ceae330ba98ca80ec18d3a8396e,3982,492,5102,9,9585,White9563b530805b8e59b46fe2492b228a3f93fe1ceae330ba98ca80ec18d3a8396e
Whitfield,9563b530805b8e59b46fe2492b228a3f93fe1ceae330ba98ca80ec18d3a8396e,11007,805,9521,23,21356,Whitfield9563b530805b8e59b46fe2492b228a3f93fe1ceae330ba98ca80ec18d3a8396e
Wilcox,9563b530805b8e59b46fe2492b228a3f93fe1ceae330ba98ca80ec18d3a8396e,1002,176,933,0,2111,Wilcox9563b530805b8e59b46fe2492b228a3f93fe1ceae330ba98ca80ec18d3a8396e
Wilkes,9563b530805b8e59b46fe2492b228a3f93fe1ceae330ba98ca80ec18d3a8396e,1284,117,1382,6,2789,Wilkes9563b530805b8e59b46fe2492b228a3f93fe1ceae330ba98ca80ec18d3a8396e
Wilkinson,9563b530805b8e59b46fe2492b228a3f93fe1ceae330ba98ca80ec18d3a8396e,1518,92,783,1,2394,Wilkinson9563b530805b8e59b46fe2492b228a3f93fe1ceae330ba98ca80ec18d3a8396e
Worth,9563b530805b8e59b46fe2492b228a3f93fe1ceae330ba98ca80ec18d3a8396e,3364,181,2549,8,6102,Worth9563b530805b8e59b46fe2492b228a3f93fe1ceae330ba98ca80ec18d3a8396e
Appling,89d97757c0c1e664c32e8822b618055de354692086995d36385fdecaf58ada69,411,83,310,0,804,Appling89d97757c0c1e664c32e8822b618055de354692086995d36385fdecaf58ada69
Atkinson,89d97757c0c1e664c32e8822b618055de354692086995d36385fdecaf58ada69,212,12,174,0,398,Atkinson89d97757c0c1e664c32e8822b618055de354692086995d36385fdecaf58ada69
Bacon,89d97757c0c1e664c32e8822b618055de354692086995d36385fdecaf58ada69,160,16,176,0,352,Bacon89d97757c0c1e664c32e8822b618055de354692086995d36385fdecaf58ada69
Baker,89d97757c0c1e664c32e8822b618055de354692086995d36385fdecaf58ada69,173,37,130,1,341,Baker89d97757c0c1e664c32e8822b618055de354692086995d36385fdecaf58ada69
Baldwin,89d97757c0c1e664c32e8822b618055de354692086995d36385fdecaf58ada69,1829,229,2083,5,4146,Baldwin89d97757c0c1e664c32e8822b618055de354692086995d36385fdecaf58ada69
Banks,89d97757c0c1e664c32e8822b618055de354692086995d36385fdecaf58ada69,404,37,307,0,748,Banks89d97757c0c1e664c32e8822b618055de354692086995d36385fdecaf58ada69
Barrow,89d97757c0c1e664c32e8822b618055de354692086995d36385fdecaf58ada69,2587,256,2793,0,5636,Barrow89d97757c0c1e664c32e8822b618055de354692086995d36385fdecaf58ada69
Bartow,89d97757c0c1e664c32e8822b618055de354692086995d36385fdecaf58ada69,3990,277,3037,5,7309,Bartow89d97757c0c1e664c32e8822b618055de354692086995d36385fdecaf58ada69
Ben Hill,89d97757c0c1e664c32e8822b618055de354692086995d36385fdecaf58ada69,382,74,759,1,1216,Ben Hill89d97757c0c1e664c32e8822b618055de354692086995d36385fdecaf58ada69
Berrien,89d97757c0c1e664c32e8822b618055de354692086995d36385fdecaf58ada69,390,59,348,8,805,Berrien89d97757c0c1e664c32e8822b618055de354692086995d36385fdecaf58ada69
Bibb,89d97757c0c1e664c32e8822b618055de354692086995d36385fdecaf58ada69,9964,1160,10048,91,21263,Bibb89d97757c0c1e664c32e8822b618055de354692086995d36385fdecaf58ada69
Bleckley,89d97757c0c1e664c32e8822b618055de354692086995d36385fdecaf58ada69,336,44,342,2,724,Bleckley89d97757c0c1e664c32e8822b618055de354692086995d36385fdecaf58ada69
Brantley,89d97757c0c1e664c32e8822b618055de354692086995d36385fdecaf58ada69,346,25,245,1,617,Brantley89d97757c0c1e664c32e8822b618055de354692086995d36385fdecaf58ada69
Brooks,89d97757c0c1e664c32e8822b618055de354692086995d36385fdecaf58ada69,566,192,515,14,1287,Brooks89d97757c0c1e664c32e8822b618055de354692086995d36385fdecaf58ada69
Bryan,89d97757c0c1e664c32e8822b618055de354692086995d36385fdecaf58ada69,1086,156,1521,3,2766,Bryan89d97757c0c1e664c32e8822b618055de354692086995d36385fdecaf58ada69
Bulloch,89d97757c0c1e664c32e8822b618055de354692086995d36385fdecaf58ada69,2617,220,2961,11,5809,Bulloch89d97757c0c1e664c32e8822b618055de354692086995d36385fdecaf58ada69
Burke,89d97757c0c1e664c32e8822b618055de354692086995d36385fdecaf58ada69,1271,276,719,0,2266,Burke89d97757c0c1e664c32e8822b618055de354692086995d36385fdecaf58ada69
Butts,89d97757c0c1e664c32e8822b618055de354692086995d36385fdecaf58ada69,536,48,1032,0,1616,Butts89d97757c0c1e664c32e8822b618055de354692086995d36385fdecaf58ada69
Calhoun,89d97757c0c1e664c32e8822b618055de354692086995d36385fdecaf58ada69,427,56,173,0,656,Calhoun89d97757c0c1e664c32e8822b618055de354692086995d36385fdecaf58ada69
Camden,89d97757c0c1e664c32e8822b618055de354692086995d36385fdecaf58ada69,1657,259,2092,3,4011,Camden89d97757c0c1e664c32e8822b618055de354692086995d36385fdecaf58ada69
Candler,89d97757c0c1e664c32e8822b618055de354692086995d36385fdecaf58ada69,241,25,334,1,601,Candler89d97757c0c1e664c32e8822b618055de354692086995d36385fdecaf58ada69
Carroll,89d97757c0c1e664c32e8822b618055de354692086995d36385fdecaf58ada69,3961,294,4825,20,9100,Carroll89d97757c0c1e664c32e8822b618055de354692086995d36385fdecaf58ada69
Catoosa,89d97757c0c1e664c32e8822b618055de354692086995d36385fdecaf58ada69,1692,109,2276,1,4078,Catoosa89d97757c0c1e664c32e8822b618055de354692086995d36385fdecaf58ada69
Charlton,89d97757c0c1e664c32e8822b618055de354692086995d36385fdecaf58ada69,295,36,321,0,652,Charlton89d97757c0c1e664c32e8822b618055de354692086995d36385fdecaf58ada69
Chatham,89d97757c0c1e664c32e8822b618055de354692086995d36385fdecaf58ada69,22708,1369,11078,45,35200,Chatham89d97757c0c1e664c32e8822b618055de354692086995d36385fdecaf58ada69
Chattahoochee,89d97757c0c1e664c32e8822b618055de354692086995d36385fdecaf58ada69,204,11,177,0,392,Chattahoochee89d97757c0c1e664c32e8822b618055de354692086995d36385fdecaf58ada69
Chattooga,89d97757c0c1e664c32e8822b618055de354692086995d36385fdecaf58ada69,597,47,596,1,1241,Chattooga89d97757c0c1e664c32e8822b618055de354692086995d36385fdecaf58ada69
Cherokee,89d97757c0c1e664c32e8822b618055de354692086995d36385fdecaf58ada69,9748,972,10796,7,21523,Cherokee89d97757c0c1e664c32e8822b618055de354692086995d36385fdecaf58ada69
Clarke,89d97757c0c1e664c32e8822b618055de354692086995d36385fdecaf58ada69,7139,735,8168,30,16072,Clarke89d97757c0c1e664c32e8822b618055de354692086995d36385fdecaf58ada69
Clay,89d97757c0c1e664c32e8822b618055de354692086995d36385fdecaf58ada69,199,29,129,1,358,Clay89d97757c0c1e664c32e8822b618055de354692086995d36385fdecaf58ada69
Clayton,89d97757c0c1e664c32e8822b618055de354692086995d36385fdecaf58ada69,19984,1292,31411,90,52777,Clayton89d97757c0c1e664c32e8822b618055de354692086995d36385fdecaf58ada69
Clinch,89d97757c0c1e664c32e8822b618055de354692086995d36385fdecaf58ada69,162,8,187,0,357,Clinch89d97757c0c1e664c32e8822b618055de354692086995d36385fdecaf58ada69
Cobb,89d97757c0c1e664c32e8822b618055de354692086995d36385fdecaf58ada69,52974,5356,47109,322,105761,Cobb89d97757c0c1e664c32e8822b618055de354692086995d36385fdecaf58ada69
Coffee,89d97757c0c1e664c32e8822b618055de354692086995d36385fdecaf58ada69,1012,73,1242,0,2327,Coffee89d97757c0c1e664c32e8822b618055de354692086995d36385fdecaf58ada69
Colquitt,89d97757c0c1e664c32e8822b618055de354692086995d36385fdecaf58ada69,1115,91,890,1,2097,Colquitt89d97757c0c1e664c32e8822b618055de354692086995d36385fdecaf58ada69
Columbia,89d97757c0c1e664c32e8822b618055de354692086995d36385fdecaf58ada69,5298,659,6353,8,12318,Columbia89d97757c0c1e664c32e8822b618055de354692086995d36385fdecaf58ada69
Cook,89d97757c0c1e664c32e8822b618055de354692086995d36385fdecaf58ada69,566,44,483,0,1093,Cook89d97757c0c1e664c32e8822b618055de354692086995d36385fdecaf58ada69
Coweta,89d97757c0c1e664c32e8822b618055de354692086995d36385fdecaf58ada69,5688,515,5736,5,11944,Coweta89d97757c0c1e664c32e8822b618055de354692086995d36385fdecaf58ada69
Crawford,89d97757c0c1e664c32e8822b618055de354692086995d36385fdecaf58ada69,407,57,425,0,889,Crawford89d97757c0c1e664c32e8822b618055de354692086995d36385fdecaf58ada69
Crisp,89d97757c0c1e664c32e8822b618055de354692086995d36385fdecaf58ada69,560,58,812,2,1432,Crisp89d97757c0c1e664c32e8822b618055de354692086995d36385fdecaf58ada69
Dade,89d97757c0c1e664c32e8822b618055de354692086995d36385fdecaf58ada69,469,30,405,0,904,Dade89d97757c0c1e664c32e8822b618055de354692086995d36385fdecaf58ada69
Dawson,89d97757c0c1e664c32e8822b618055de354692086995d36385fdecaf58ada69,479,86,1036,2,1603,Dawson89d97757c0c1e664c32e8822b618055de354692086995d36385fdecaf58ada69
Decatur,89d97757c0c1e664c32e8822b618055de354692086995d36385fdecaf58ada69,1066,126,1158,10,2360,Decatur89d97757c0c1e664c32e8822b618055de354692086995d36385fdecaf58ada69
DeKalb,89d97757c0c1e664c32e8822b618055de354692086995d36385fdecaf58ada69,58873,5840,89365,281,154359,DeKalb89d97757c0c1e664c32e8822b618055de354692086995d36385fdecaf58ada69
Dodge,89d97757c0c1e664c32e8822b618055de354692086995d36385fdecaf58ada69,562,55,433,0,1050,Dodge89d97757c0c1e664c32e8822b618055de354692086995d36385fdecaf58ada69
Dooly,89d97757c0c1e664c32e8822b618055de354692086995d36385fdecaf58ada69,513,54,340,6,913,Dooly89d97757c0c1e664c32e8822b618055de354692086995d36385fdecaf58ada69
Dougherty,89d97757c0c1e664c32e8822b618055de354692086995d36385fdecaf58ada69,7294,624,5829,45,13792,Dougherty89d97757c0c1e664c32e8822b618055de354692086995d36385fdecaf58ada69
Douglas,89d97757c0c1e664c32e8822b618055de354692086995d36385fdecaf58ada69,7598,688,12187,14,20487,Douglas89d97757c0c1e664c32e8822b618055de354692086995d36385fdecaf58ada69
Early,89d97757c0c1e664c32e8822b618055de354692086995d36385fdecaf58ada69,633,153,440,0,1226,Early89d97757c0c1e664c32e8822b618055de354692086995d36385fdecaf58ada69
Echols,89d97757c0c1e664c32e8822b618055de354692086995d36385fdecaf58ada69,60,2,43,0,105,Echols89d97757c0c1e664c32e8822b618055de354692086995d36385fdecaf58ada69
Effingham,89d97757c0c1e664c32e8822b618055de354692086995d36385fdecaf58ada69,1799,134,1481,0,3414,Effingham89d97757c0c1e664c32e8822b618055de354692086995d36385fdecaf58ada69
Elbert,89d97757c0c1e664c32e8822b618055de354692086995d36385fdecaf58ada69,494,94,780,19,1387,Elbert89d97757c0c1e664c32e8822b618055de354692086995d36385fdecaf58ada69
Emanuel,89d97757c0c1e664c32e8822b618055de354692086995d36385fdecaf58ada69,695,52,493,1,1241,Emanuel89d97757c0c1e664c32e8822b618055de354692086995d36385fdecaf58ada69
Evans,89d97757c0c1e664c32e8822b618055de354692086995d36385fdecaf58ada69,237,28,321,0,586,Evans89d97757c0c1e664c32e8822b618055de354692086995d36385fdecaf58ada69
Fannin,89d97757c0c1e664c32e8822b618055de354692086995d36385fdecaf58ada69,652,152,804,1,1609,Fannin89d97757c0c1e664c32e8822b618055de354692086995d36385fdecaf58ada69
Fayette,89d97757c0c1e664c32e8822b618055de354692086995d36385fdecaf58ada69,4811,589,9543,11,14954,Fayette89d97757c0c1e664c32e8822b618055de354692086995d36385fdecaf58ada69
Floyd,89d97757c0c1e664c32e8822b618055de354692086995d36385fdecaf58ada69,2706,252,3080,22,6060,Floyd89d97757c0c1e664c32e8822b618055de354692086995d36385fdecaf58ada69
Forsyth,89d97757c0c1e664c32e8822b618055de354692086995d36385fdecaf58ada69,5368,731,11544,8,17651,Forsyth89d97757c0c1e664c32e8822b618055de354692086995d36385fdecaf58ada69
Franklin,89d97757c0c1e664c32e8822b618055de354692086995d36385fdecaf58ada69,564,42,414,0,1020,Franklin89d97757c0c1e664c32e8822b618055de354692086995d36385fdecaf58ada69
Fulton,89d97757c0c1e664c32e8822b618055de354692086995d36385fdecaf58ada69,68595,6839,106540,652,182626,Fulton89d97757c0c1e664c32e8822b618055de354692086995d36385fdecaf58ada69
Gilmer,89d97757c0c1e664c32e8822b618055de354692086995d36385fdecaf58ada69,781,102,996,5,1884,Gilmer89d97757c0c1e664c32e8822b618055de354692086995d36385fdecaf58ada69
Glascock,89d97757c0c1e664c32e8822b618055de354692086995d36385fdecaf58ada69,69,7,49,0,125,Glascock89d97757c0c1e664c32e8822b618055de354692086995d36385fdecaf58ada69
Glynn,89d97757c0c1e664c32e8822b618055de354692086995d36385fdecaf58ada69,2962,330,3360,12,6664,Glynn89d97757c0c1e664c32e8822b618055de354692086995d36385fdecaf58ada69
Gordon,89d97757c0c1e664c32e8822b618055de354692086995d36385fdecaf58ada69,1335,92,1296,4,2727,Gordon89d97757c0c1e664c32e8822b618055de354692086995d36385fdecaf58ada69
Grady,89d97757c0c1e664c32e8822b618055de354692086995d36385fdecaf58ada69,766,65,925,4,1760,Grady89d97757c0c1e664c32e8822b618055de354692086995d36385fdecaf58ada69
Greene,89d97757c0c1e664c32e8822b618055de354692086995d36385fdecaf58ada69,617,145,778,3,1543,Greene89d97757c0c1e664c32e8822b618055de354692086995d36385fdecaf58ada69
Gwinnett,89d97757c0c1e664c32e8822b618055de354692086995d36385fdecaf58ada69,53664,4325,50980,653,109622,Gwinnett89d97757c0c1e664c32e8822b618055de354692086995d36385fdecaf58ada69
Habersham,89d97757c0c1e664c32e8822b618055de354692086995d36385fdecaf58ada69,566,129,1362,1,2058,Habersham89d97757c0c1e664c32e8822b618055de354692086995d36385fdecaf58ada69
Hall,89d97757c0c1e664c32e8822b618055de354692086995d36385fdecaf58ada69,5721,592,5621,16,11950,Hall89d97757c0c1e664c32e8822b618055de354692086995d36385fdecaf58ada69
Hancock,89d97757c0c1e664c32e8822b618055de354692086995d36385fdecaf58ada69,657,112,401,1,1171,Hancock89d97757c0c1e664c32e8822b618055de354692086995d36385fdecaf58ada69
Haralson,89d97757c0c1e664c32e8822b618055de354692086995d36385fdecaf58ada69,767,62,630,1,1460,Haralson89d97757c0c1e664c32e8822b618055de354692086995d36385fdecaf58ada69
Harris,89d97757c0c1e664c32e8822b618055de354692086995d36385fdecaf58ada69,1238,140,1371,0,2749,Harris89d97757c0c1e664c32e8822b618055de354692086995d36385fdecaf58ada69
Hart,89d97757c0c1e664c32e8822b618055de354692086995d36385fdecaf58ada69,659,105,733,0,1497,Hart89d97757c0c1e664c32e8822b618055de354692086995d36385fdecaf58ada69
Heard,89d97757c0c1e664c32e8822b618055de354692086995d36385fdecaf58ada69,299,41,230,1,571,Heard89d97757c0c1e664c32e8822b618055de354692086995d36385fdecaf58ada69
Henry,89d97757c0c1e664c32e8822b618055de354692086995d36385fdecaf58ada69,9923,977,22818,76,33794,Henry89d97757c0c1e664c32e8822b618055de354692086995d36385fdecaf58ada69
Houston,89d97757c0c1e664c32e8822b618055de354692086995d36385fdecaf58ada69,5102,550,8362,35,14049,Houston89d97757c0c1e664c32e8822b618055de354692086995d36385fdecaf58ada69
Irwin,89d97757c0c1e664c32e8822b618055de354692086995d36385fdecaf58ada69,259,19,256,0,534,Irwin89d97757c0c1e664c32e8822b618055de354692086995d36385fdecaf58ada69
Jackson,89d97757c0c1e664c32e8822b618055de354692086995d36385fdecaf58ada69,1564,94,2256,9,3923,Jackson89d97757c0c1e664c32e8822b618055de354692086995d36385fdecaf58ada69
Jasper,89d97757c0c1e664c32e8822b618055de354692086995d36385fdecaf58ada69,433,90,551,0,1074,Jasper89d97757c0c1e664c32e8822b618055de354692086995d36385fdecaf58ada69
Jeff Davis,89d97757c0c1e664c32e8822b618055de354692086995d36385fdecaf58ada69,303,21,228,0,552,Jeff Davis89d97757c0c1e664c32e8822b618055de354692086995d36385fdecaf58ada69
Jefferson,89d97757c0c1e664c32e8822b618055de354692086995d36385fdecaf58ada69,904,134,573,6,1617,Jefferson89d97757c0c1e664c32e8822b618055de354692086995d36385fdecaf58ada69
Jenkins,89d97757c0c1e664c32e8822b618055de354692086995d36385fdecaf58ada69,276,34,251,6,567,Jenkins89d97757c0c1e664c32e8822b618055de354692086995d36385fdecaf58ada69
Johnson,89d97757c0c1e664c32e8822b618055de354692086995d36385fdecaf58ada69,262,44,272,0,578,Johnson89d97757c0c1e664c32e8822b618055de354692086995d36385fdecaf58ada69
Jones,89d97757c0c1e664c32e8822b618055de354692086995d36385fdecaf58ada69,974,159,1263,0,2396,Jones89d97757c0c1e664c32e8822b618055de354692086995d36385fdecaf58ada69
Lamar,89d97757c0c1e664c32e8822b618055de354692086995d36385fdecaf58ada69,604,76,808,5,1493,Lamar89d97757c0c1e664c32e8822b618055de354692086995d36385fdecaf58ada69
Lanier,89d97757c0c1e664c32e8822b618055de354692086995d36385fdecaf58ada69,210,17,236,0,463,Lanier89d97757c0c1e664c32e8822b618055de354692086995d36385fdecaf58ada69
Laurens,89d97757c0c1e664c32e8822b618055de354692086995d36385fdecaf58ada69,1906,215,1543,1,3665,Laurens89d97757c0c1e664c32e8822b618055de354692086995d36385fdecaf58ada69
Lee,89d97757c0c1e664c32e8822b618055de354692086995d36385fdecaf58ada69,1043,90,939,1,2073,Lee89d97757c0c1e664c32e8822b618055de354692086995d36385fdecaf58ada69
Liberty,89d97757c0c1e664c32e8822b618055de354692086995d36385fdecaf58ada69,2109,165,3301,18,5593,Liberty89d97757c0c1e664c32e8822b618055de354692086995d36385fdecaf58ada69
Lincoln,89d97757c0c1e664c32e8822b618055de354692086995d36385fdecaf58ada69,277,96,290,1,664,Lincoln89d97757c0c1e664c32e8822b618055de354692086995d36385fdecaf58ada69
Long,89d97757c0c1e664c32e8822b618055de354692086995d36385fdecaf58ada69,420,30,418,3,871,Long89d97757c0c1e664c32e8822b618055de354692086995d36385fdecaf58ada69
Lowndes,89d97757c0c1e664c32e8822b618055de354692086995d36385fdecaf58ada69,3041,370,5628,208,9247,Lowndes89d97757c0c1e664c32e8822b618055de354692086995d36385fdecaf58ada69
Lumpkin,89d97757c0c1e664c32e8822b618055de354692086995d36385fdecaf58ada69,591,107,1436,2,2136,Lumpkin89d97757c0c1e664c32e8822b618055de354692086995d36385fdecaf58ada69
Macon,89d97757c0c1e664c32e8822b618055de354692086995d36385fdecaf58ada69,669,100,542,0,1311,Macon89d97757c0c1e664c32e8822b618055de354692086995d36385fdecaf58ada69
Madison,89d97757c0c1e664c32e8822b618055de354692086995d36385fdecaf58ada69,804,77,891,1,1773,Madison89d97757c0c1e664c32e8822b618055de354692086995d36385fdecaf58ada69
Marion,89d97757c0c1e664c32e8822b618055de354692086995d36385fdecaf58ada69,324,80,271,0,675,Marion89d97757c0c1e664c32e8822b618055de354692086995d36385fdecaf58ada69
McDuffie,89d97757c0c1e664c32e8822b618055de354692086995d36385fdecaf58ada69,833,122,1043,0,1998,McDuffie89d97757c0c1e664c32e8822b618055de354692086995d36385fdecaf58ada69
McIntosh,89d97757c0c1e664c32e8822b618055de354692086995d36385fdecaf58ada69,561,102,570,2,1235,McIntosh89d97757c0c1e664c32e8822b618055de354692086995d36385fdecaf58ada69
Meriwether,89d97757c0c1e664c32e8822b618055de354692086995d36385fdecaf58ada69,1373,116,777,3,2269,Meriwether89d97757c0c1e664c32e8822b618055de354692086995d36385fdecaf58ada69
Miller,89d97757c0c1e664c32e8822b618055de354692086995d36385fdecaf58ada69,205,27,116,0,348,Miller89d97757c0c1e664c32e8822b618055de354692086995d36385fdecaf58ada69
Mitchell,89d97757c0c1e664c32e8822b618055de354692086995d36385fdecaf58ada69,872,158,880,2,1912,Mitchell89d97757c0c1e664c32e8822b618055de354692086995d36385fdecaf58ada69
Monroe,89d97757c0c1e664c32e8822b618055de354692086995d36385fdecaf58ada69,957,108,1077,2,2144,Monroe89d97757c0c1e664c32e8822b618055de354692086995d36385fdecaf58ada69
Montgomery,89d97757c0c1e664c32e8822b618055de354692086995d36385fdecaf58ada69,292,24,165,0,481,Montgomery89d97757c0c1e664c32e8822b618055de354692086995d36385fdecaf58ada69
Morgan,89d97757c0c1e664c32e8822b618055de354692086995d36385fdecaf58ada69,668,79,913,1,1661,Morgan89d97757c0c1e664c32e8822b618055de354692086995d36385fdecaf58ada69
Murray,89d97757c0c1e664c32e8822b618055de354692086995d36385fdecaf58ada69,937,70,722,0,1729,Murray89d97757c0c1e664c32e8822b618055de354692086995d36385fdecaf58ada69
Muscogee,89d97757c0c1e664c32e8822b618055de354692086995d36385fdecaf58ada69,11609,1245,12743,70,25667,Muscogee89d97757c0c1e664c32e8822b618055de354692086995d36385fdecaf58ada69
Newton,89d97757c0c1e664c32e8822b618055de354692086995d36385fdecaf58ada69,6308,550,7288,2,14148,Newton89d97757c0c1e664c32e8822b618055de354692086995d36385fdecaf58ada69
Oconee,89d97757c0c1e664c32e8822b618055de354692086995d36385fdecaf58ada69,1329,136,1879,0,3344,Oconee89d97757c0c1e664c32e8822b618055de354692086995d36385fdecaf58ada69
Oglethorpe,89d97757c0c1e664c32e8822b618055de354692086995d36385fdecaf58ada69,514,53,660,1,1228,Oglethorpe89d97757c0c1e664c32e8822b618055de354692086995d36385fdecaf58ada69
Paulding,89d97757c0c1e664c32e8822b618055de354692086995d36385fdecaf58ada69,4874,629,8829,11,14343,Paulding89d97757c0c1e664c32e8822b618055de354692086995d36385fdecaf58ada69
Peach,89d97757c0c1e664c32e8822b618055de354692086995d36385fdecaf58ada69,1112,101,1861,7,3081,Peach89d97757c0c1e664c32e8822b618055de354692086995d36385fdecaf58ada69
Pickens,89d97757c0c1e664c32e8822b618055de354692086995d36385fdecaf58ada69,750,39,1168,2,1959,Pickens89d97757c0c1e664c32e8822b618055de354692086995d36385fdecaf58ada69
Pierce,89d97757c0c1e664c32e8822b618055de354692086995d36385fdecaf58ada69,200,29,398,0,627,Pierce89d97757c0c1e664c32e8822b618055de354692086995d36385fdecaf58ada69
Pike,89d97757c0c1e664c32e8822b618055de354692086995d36385fdecaf58ada69,426,57,555,0,1038,Pike89d97757c0c1e664c32e8822b618055de354692086995d36385fdecaf58ada69
Polk,89d97757c0c1e664c32e8822b618055de354692086995d36385fdecaf58ada69,818,95,1449,1,2363,Polk89d97757c0c1e664c32e8822b618055de354692086995d36385fdecaf58ada69
Pulaski,89d97757c0c1e664c32e8822b618055de354692086995d36385fdecaf58ada69,191,45,331,0,567,Pulaski89d97757c0c1e664c32e8822b618055de354692086995d36385fdecaf58ada69
Putnam,89d97757c0c1e664c32e8822b618055de354692086995d36385fdecaf58ada69,702,111,883,1,1697,Putnam89d97757c0c1e664c32e8822b618055de354692086995d36385fdecaf58ada69
Quitman,89d97757c0c1e664c32e8822b618055de354692086995d36385fdecaf58ada69,132,14,107,0,253,Quitman89d97757c0c1e664c32e8822b618055de354692086995d36385fdecaf58ada69
Rabun,89d97757c0c1e664c32e8822b618055de354692086995d36385fdecaf58ada69,204,135,720,0,1059,Rabun89d97757c0c1e664c32e8822b618055de354692086995d36385fdecaf58ada69
Randolph,89d97757c0c1e664c32e8822b618055de354692086995d36385fdecaf58ada69,409,75,311,1,796,Randolph89d97757c0c1e664c32e8822b618055de354692086995d36385fdecaf58ada69
Richmond,89d97757c0c1e664c32e8822b618055de354692086995d36385fdecaf58ada69,13249,1485,13443,63,28240,Richmond89d97757c0c1e664c32e8822b618055de354692086995d36385fdecaf58ada69
Rockdale,89d97757c0c1e664c32e8822b618055de354692086995d36385fdecaf58ada69,4399,442,9984,18,14843,Rockdale89d97757c0c1e664c32e8822b618055de354692086995d36385fdecaf58ada69
Schley,89d97757c0c1e664c32e8822b618055de354692086995d36385fdecaf58ada69,101,18,134,0,253,Schley89d97757c0c1e664c32e8822b618055de354692086995d36385fdecaf58ada69
Screven,89d97757c0c1e664c32e8822b618055de354692086995d36385fdecaf58ada69,672,43,509,0,1224,Screven89d97757c0c1e664c32e8822b618055de354692086995d36385fdecaf58ada69
Seminole,89d97757c0c1e664c32e8822b618055de354692086995d36385fdecaf58ada69,406,33,247,3,689,Seminole89d97757c0c1e664c32e8822b618055de354692086995d36385fdecaf58ada69
Spalding,89d97757c0c1e664c32e8822b618055de354692086995d36385fdecaf58ada69,2484,219,3104,7,5814,Spalding89d97757c0c1e664c32e8822b618055de354692086995d36385fdecaf58ada69
Stephens,89d97757c0c1e664c32e8822b618055de354692086995d36385fdecaf58ada69,357,90,842,0,1289,Stephens89d97757c0c1e664c32e8822b618055de354692086995d36385fdecaf58ada69
Stewart,89d97757c0c1e664c32e8822b618055de354692086995d36385fdecaf58ada69,292,92,171,1,556,Stewart89d97757c0c1e664c32e8822b618055de354692086995d36385fdecaf58ada69
Sumter,89d97757c0c1e664c32e8822b618055de354692086995d36385fdecaf58ada69,1220,247,1600,0,3067,Sumter89d97757c0c1e664c32e8822b618055de354692086995d36385fdecaf58ada69
Talbot,89d97757c0c1e664c32e8822b618055de354692086995d36385fdecaf58ada69,598,206,236,0,1040,Talbot89d97757c0c1e664c32e8822b618055de354692086995d36385fdecaf58ada69
Taliaferro,89d97757c0c1e664c32e8822b618055de354692086995d36385fdecaf58ada69,86,36,107,1,230,Taliaferro89d97757c0c1e664c32e8822b618055de354692086995d36385fdecaf58ada69
Tattnall,89d97757c0c1e664c32e8822b618055de354692086995d36385fdecaf58ada69,436,64,431,2,933,Tattnall89d97757c0c1e664c32e8822b618055de354692086995d36385fdecaf58ada69
Taylor,89d97757c0c1e664c32e8822b618055de354692086995d36385fdecaf58ada69,379,81,288,0,748,Taylor89d97757c0c1e664c32e8822b618055de354692086995d36385fdecaf58ada69
Telfair,89d97757c0c1e664c32e8822b618055de354692086995d36385fdecaf58ada69,355,53,199,0,607,Telfair89d97757c0c1e664c32e8822b618055de354692086995d36385fdecaf58ada69
Terrell,89d97757c0c1e664c32e8822b618055de354692086995d36385fdecaf58ada69,626,99,496,0,1221,Terrell89d97757c0c1e664c32e8822b618055de354692086995d36385fdecaf58ada69
Thomas,89d97757c0c1e664c32e8822b618055de354692086995d36385fdecaf58ada69,1652,209,2097,0,3958,Thomas89d97757c0c1e664c32e8822b618055de354692086995d36385fdecaf58ada69
Tift,89d97757c0c1e664c32e8822b618055de354692086995d36385fdecaf58ada69,1057,96,1227,2,2382,Tift89d97757c0c1e664c32e8822b618055de354692086995d36385fdecaf58ada69
Toombs,89d97757c0c1e664c32e8822b618055de354692086995d36385fdecaf58ada69,670,109,594,0,1373,Toombs89d97757c0c1e664c32e8822b618055de354692086995d36385fdecaf58ada69
Towns,89d97757c0c1e664c32e8822b618055de354692086995d36385fdecaf58ada69,268,56,529,5,858,Towns89d97757c0c1e664c32e8822b618055de354692086995d36385fdecaf58ada69
Treutlen,89d97757c0c1e664c32e8822b618055de354692086995d36385fdecaf58ada69,166,32,220,0,418,Treutlen89d97757c0c1e664c32e8822b618055de354692086995d36385fdecaf58ada69
Troup,89d97757c0c1e664c32e8822b618055de354692086995d36385fdecaf58ada69,3017,271,2560,74,5922,Troup89d97757c0c1e664c32e8822b618055de354692086995d36385fdecaf58ada69
Turner,89d97757c0c1e664c32e8822b618055de354692086995d36385fdecaf58ada69,325,16,382,1,724,Turner89d97757c0c1e664c32e8822b618055de354692086995d36385fdecaf58ada69
Twiggs,89d97757c0c1e664c32e8822b618055de354692086995d36385fdecaf58ada69,565,115,418,0,1098,Twiggs89d97757c0c1e664c32e8822b618055de354692086995d36385fdecaf58ada69
Union,89d97757c0c1e664c32e8822b618055de354692086995d36385fdecaf58ada69,495,86,852,0,1433,Union89d97757c0c1e664c32e8822b618055de354692086995d36385fdecaf58ada69
Upson,89d97757c0c1e664c32e8822b618055de354692086995d36385fdecaf58ada69,792,76,1223,2,2093,Upson89d97757c0c1e664c32e8822b618055de354692086995d36385fdecaf58ada69
Walker,89d97757c0c1e664c32e8822b618055de354692086995d36385fdecaf58ada69,1741,177,1924,4,3846,Walker89d97757c0c1e664c32e8822b618055de354692086995d36385fdecaf58ada69
Walton,89d97757c0c1e664c32e8822b618055de354692086995d36385fdecaf58ada69,3489,283,2778,9,6559,Walton89d97757c0c1e664c32e8822b618055de354692086995d36385fdecaf58ada69
Ware,89d97757c0c1e664c32e8822b618055de354692086995d36385fdecaf58ada69,734,129,1212,3,2078,Ware89d97757c0c1e664c32e8822b618055de354692086995d36385fdecaf58ada69
Warren,89d97757c0c1e664c32e8822b618055de354692086995d36385fdecaf58ada69,306,23,267,1,597,Warren89d97757c0c1e664c32e8822b618055de354692086995d36385fdecaf58ada69
Washington,89d97757c0c1e664c32e8822b618055de354692086995d36385fdecaf58ada69,900,184,791,10,1885,Washington89d97757c0c1e664c32e8822b618055de354692086995d36385fdecaf58ada69
Wayne,89d97757c0c1e664c32e8822b618055de354692086995d36385fdecaf58ada69,588,51,729,3,1371,Wayne89d97757c0c1e664c32e8822b618055de354692086995d36385fdecaf58ada69
Webster,89d97757c0c1e664c32e8822b618055de354692086995d36385fdecaf58ada69,128,34,81,1,244,Webster89d97757c0c1e664c32e8822b618055de354692086995d36385fdecaf58ada69
Wheeler,89d97757c0c1e664c32e8822b618055de354692086995d36385fdecaf58ada69,147,25,154,0,326,Wheeler89d97757c0c1e664c32e8822b618055de354692086995d36385fdecaf58ada69
White,89d97757c0c1e664c32e8822b618055de354692086995d36385fdecaf58ada69,654,91,840,2,1587,White89d97757c0c1e664c32e8822b618055de354692086995d36385fdecaf58ada69
Whitfield,89d97757c0c1e664c32e8822b618055de354692086995d36385fdecaf58ada69,3320,240,2403,8,5971,Whitfield89d97757c0c1e664c32e8822b618055de354692086995d36385fdecaf58ada69
Wilcox,89d97757c0c1e664c32e8822b618055de354692086995d36385fdecaf58ada69,289,28,131,0,448,Wilcox89d97757c0c1e664c32e8822b618055de354692086995d36385fdecaf58ada69
Wilkes,89d97757c0c1e664c32e8822b618055de354692086995d36385fdecaf58ada69,439,36,337,0,812,Wilkes89d97757c0c1e664c32e8822b618055de354692086995d36385fdecaf58ada69
Wilkinson,89d97757c0c1e664c32e8822b618055de354692086995d36385fdecaf58ada69,508,64,351,0,923,Wilkinson89d97757c0c1e664c32e8822b618055de354692086995d36385fdecaf58ada69
Worth,89d97757c0c1e664c32e8822b618055de354692086995d36385fdecaf58ada69,672,60,578,1,1311,Worth89d97757c0c1e664c32e8822b618055de354692086995d36385fdecaf58ada69
Bacon,91b95ec0c9eef078447afcb79a7748ad35bd7260822cf9e039bf2289a7baf0e7,1148,135,1993,5,3281,Bacon91b95ec0c9eef078447afcb79a7748ad35bd7260822cf9e039bf2289a7baf0e7
Brantley,91b95ec0c9eef078447afcb79a7748ad35bd7260822cf9e039bf2289a7baf0e7,2493,197,2749,7,5446,Brantley91b95ec0c9eef078447afcb79a7748ad35bd7260822cf9e039bf2289a7baf0e7
Bryan,91b95ec0c9eef078447afcb79a7748ad35bd7260822cf9e039bf2289a7baf0e7,4877,391,7684,10,12962,Bryan91b95ec0c9eef078447afcb79a7748ad35bd7260822cf9e039bf2289a7baf0e7
Camden,91b95ec0c9eef078447afcb79a7748ad35bd7260822cf9e039bf2289a7baf0e7,6098,849,8327,16,15290,Camden91b95ec0c9eef078447afcb79a7748ad35bd7260822cf9e039bf2289a7baf0e7
Charlton,91b95ec0c9eef078447afcb79a7748ad35bd7260822cf9e039bf2289a7baf0e7,1349,172,1700,8,3229,Charlton91b95ec0c9eef078447afcb79a7748ad35bd7260822cf9e039bf2289a7baf0e7
Chatham,91b95ec0c9eef078447afcb79a7748ad35bd7260822cf9e039bf2289a7baf0e7,53004,3366,24266,82,80718,Chatham91b95ec0c9eef078447afcb79a7748ad35bd7260822cf9e039bf2289a7baf0e7
Clinch,91b95ec0c9eef078447afcb79a7748ad35bd7260822cf9e039bf2289a7baf0e7,784,66,1061,3,1914,Clinch91b95ec0c9eef078447afcb79a7748ad35bd7260822cf9e039bf2289a7baf0e7
Echols,91b95ec0c9eef078447afcb79a7748ad35bd7260822cf9e039bf2289a7baf0e7,423,40,587,0,1050,Echols91b95ec0c9eef078447afcb79a7748ad35bd7260822cf9e039bf2289a7baf0e7
Effingham,91b95ec0c9eef078447afcb79a7748ad35bd7260822cf9e039bf2289a7baf0e7,6502,350,6141,1,12994,Effingham91b95ec0c9eef078447afcb79a7748ad35bd7260822cf9e039bf2289a7baf0e7
Glynn,91b95ec0c9eef078447afcb79a7748ad35bd7260822cf9e039bf2289a7baf0e7,11431,1084,14405,39,26959,Glynn91b95ec0c9eef078447afcb79a7748ad35bd7260822cf9e039bf2289a7baf0e7
Liberty,91b95ec0c9eef078447afcb79a7748ad35bd7260822cf9e039bf2289a7baf0e7,4871,408,6374,28,11681,Liberty91b95ec0c9eef078447afcb79a7748ad35bd7260822cf9e039bf2289a7baf0e7
Long,91b95ec0c9eef078447afcb79a7748ad35bd7260822cf9e039bf2289a7baf0e7,1664,67,1582,6,3319,Long91b95ec0c9eef078447afcb79a7748ad35bd7260822cf9e039bf2289a7baf0e7
Lowndes,91b95ec0c9eef078447afcb79a7748ad35bd7260822cf9e039bf2289a7baf0e7,500,36,618,11,1165,Lowndes91b95ec0c9eef078447afcb79a7748ad35bd7260822cf9e039bf2289a7baf0e7
McIntosh,91b95ec0c9eef078447afcb79a7748ad35bd7260822cf9e039bf2289a7baf0e7,1712,444,2300,7,4463,McIntosh91b95ec0c9eef078447afcb79a7748ad35bd7260822cf9e039bf2289a7baf0e7
Pierce,91b95ec0c9eef078447afcb79a7748ad35bd7260822cf9e039bf2289a7baf0e7,1839,308,4396,1,6544,Pierce91b95ec0c9eef078447afcb79a7748ad35bd7260822cf9e039bf2289a7baf0e7
Ware,91b95ec0c9eef078447afcb79a7748ad35bd7260822cf9e039bf2289a7baf0e7,4161,480,5544,6,10191,Ware91b95ec0c9eef078447afcb79a7748ad35bd7260822cf9e039bf2289a7baf0e7
Wayne,91b95ec0c9eef078447afcb79a7748ad35bd7260822cf9e039bf2289a7baf0e7,3819,334,4876,8,9037,Wayne91b95ec0c9eef078447afcb79a7748ad35bd7260822cf9e039bf2289a7baf0e7
Baker,5a7b3828d75e787a612a115351b887fc92af2557b8499da0870178d53014bd95,313,61,253,0,627,Baker5a7b3828d75e787a612a115351b887fc92af2557b8499da0870178d53014bd95
Bibb,5a7b3828d75e787a612a115351b887fc92af2557b8499da0870178d53014bd95,5627,528,4566,17,10738,Bibb5a7b3828d75e787a612a115351b887fc92af2557b8499da0870178d53014bd95
Calhoun,5a7b3828d75e787a612a115351b887fc92af2557b8499da0870178d53014bd95,335,34,259,1,629,Calhoun5a7b3828d75e787a612a115351b887fc92af2557b8499da0870178d53014bd95
Chattahoochee,5a7b3828d75e787a612a115351b887fc92af2557b8499da0870178d53014bd95,371,35,250,5,661,Chattahoochee5a7b3828d75e787a612a115351b887fc92af2557b8499da0870178d53014bd95
Clay,5a7b3828d75e787a612a115351b887fc92af2557b8499da0870178d53014bd95,127,34,302,2,465,Clay5a7b3828d75e787a612a115351b887fc92af2557b8499da0870178d53014bd95
Crawford,5a7b3828d75e787a612a115351b887fc92af2557b8499da0870178d53014bd95,1417,124,1602,3,3146,Crawford5a7b3828d75e787a612a115351b887fc92af2557b8499da0870178d53014bd95
Crisp,5a7b3828d75e787a612a115351b887fc92af2557b8499da0870178d53014bd95,1109,169,2501,7,3786,Crisp5a7b3828d75e787a612a115351b887fc92af2557b8499da0870178d53014bd95
Decatur,5a7b3828d75e787a612a115351b887fc92af2557b8499da0870178d53014bd95,1920,234,2956,10,5120,Decatur5a7b3828d75e787a612a115351b887fc92af2557b8499da0870178d53014bd95
Dooly,5a7b3828d75e787a612a115351b887fc92af2557b8499da0870178d53014bd95,642,48,797,3,1490,Dooly5a7b3828d75e787a612a115351b887fc92af2557b8499da0870178d53014bd95
Dougherty,5a7b3828d75e787a612a115351b887fc92af2557b8499da0870178d53014bd95,5572,471,3575,10,9628,Dougherty5a7b3828d75e787a612a115351b887fc92af2557b8499da0870178d53014bd95
Early,5a7b3828d75e787a612a115351b887fc92af2557b8499da0870178d53014bd95,816,107,982,0,1905,Early5a7b3828d75e787a612a115351b887fc92af2557b8499da0870178d53014bd95
Grady,5a7b3828d75e787a612a115351b887fc92af2557b8499da0870178d53014bd95,2121,141,2672,3,4937,Grady5a7b3828d75e787a612a115351b887fc92af2557b8499da0870178d53014bd95
Lee,5a7b3828d75e787a612a115351b887fc92af2557b8499da0870178d53014bd95,4586,311,5049,3,9949,Lee5a7b3828d75e787a612a115351b887fc92af2557b8499da0870178d53014bd95
Macon,5a7b3828d75e787a612a115351b887fc92af2557b8499da0870178d53014bd95,424,55,746,0,1225,Macon5a7b3828d75e787a612a115351b887fc92af2557b8499da0870178d53014bd95
Marion,5a7b3828d75e787a612a115351b887fc92af2557b8499da0870178d53014bd95,878,57,648,0,1583,Marion5a7b3828d75e787a612a115351b887fc92af2557b8499da0870178d53014bd95
Miller,5a7b3828d75e787a612a115351b887fc92af2557b8499da0870178d53014bd95,640,90,822,1,1553,Miller5a7b3828d75e787a612a115351b887fc92af2557b8499da0870178d53014bd95
Mitchell,5a7b3828d75e787a612a115351b887fc92af2557b8499da0870178d53014bd95,1645,152,1700,5,3502,Mitchell5a7b3828d75e787a612a115351b887fc92af2557b8499da0870178d53014bd95
Muscogee,5a7b3828d75e787a612a115351b887fc92af2557b8499da0870178d53014bd95,6391,887,6368,15,13661,Muscogee5a7b3828d75e787a612a115351b887fc92af2557b8499da0870178d53014bd95
Peach,5a7b3828d75e787a612a115351b887fc92af2557b8499da0870178d53014bd95,1412,155,3436,9,5012,Peach5a7b3828d75e787a612a115351b887fc92af2557b8499da0870178d53014bd95
Quitman,5a7b3828d75e787a612a115351b887fc92af2557b8499da0870178d53014bd95,165,28,211,0,404,Quitman5a7b3828d75e787a612a115351b887fc92af2557b8499da0870178d53014bd95
Randolph,5a7b3828d75e787a612a115351b887fc92af2557b8499da0870178d53014bd95,473,27,424,1,925,Randolph5a7b3828d75e787a612a115351b887fc92af2557b8499da0870178d53014bd95
Schley,5a7b3828d75e787a612a115351b887fc92af2557b8499da0870178d53014bd95,369,44,866,0,1279,Schley5a7b3828d75e787a612a115351b887fc92af2557b8499da0870178d53014bd95
Seminole,5a7b3828d75e787a612a115351b887fc92af2557b8499da0870178d53014bd95,1064,93,800,2,1959,Seminole5a7b3828d75e787a612a115351b887fc92af2557b8499da0870178d53014bd95
Stewart,5a7b3828d75e787a612a115351b887fc92af2557b8499da0870178d53014bd95,221,82,224,2,529,Stewart5a7b3828d75e787a612a115351b887fc92af2557b8499da0870178d53014bd95
Sumter,5a7b3828d75e787a612a115351b887fc92af2557b8499da0870178d53014bd95,1986,242,2318,1,4547,Sumter5a7b3828d75e787a612a115351b887fc92af2557b8499da0870178d53014bd95
Talbot,5a7b3828d75e787a612a115351b887fc92af2557b8499da0870178d53014bd95,662,78,289,0,1029,Talbot5a7b3828d75e787a612a115351b887fc92af2557b8499da0870178d53014bd95
Taylor,5a7b3828d75e787a612a115351b887fc92af2557b8499da0870178d53014bd95,562,92,1051,0,1705,Taylor5a7b3828d75e787a612a115351b887fc92af2557b8499da0870178d53014bd95
Terrell,5a7b3828d75e787a612a115351b887fc92af2557b8499da0870178d53014bd95,726,72,747,2,1547,Terrell5a7b3828d75e787a612a115351b887fc92af2557b8499da0870178d53014bd95
Webster,5a7b3828d75e787a612a115351b887fc92af2557b8499da0870178d53014bd95,189,51,275,0,515,Webster5a7b3828d75e787a612a115351b887fc92af2557b8499da0870178d53014bd95
Baker,e1d8a38e074337775565bdb78b5c22794feb548ee246c1dc77e5f0f5ad2612ff,389,86,300,2,777,Bakere1d8a38e074337775565bdb78b5c22794feb548ee246c1dc77e5f0f5ad2612ff
Bibb,e1d8a38e074337775565bdb78b5c22794feb548ee246c1dc77e5f0f5ad2612ff,12561,1772,14236,95,28664,Bibbe1d8a38e074337775565bdb78b5c22794feb548ee246c1dc77e5f0f5ad2612ff
Calhoun,e1d8a38e074337775565bdb78b5c22794feb548ee246c1dc77e5f0f5ad2612ff,849,118,400,1,1368,Calhoune1d8a38e074337775565bdb78b5c22794feb548ee246c1dc77e5f0f5ad2612ff
Chattahoochee,e1d8a38e074337775565bdb78b5c22794feb548ee246c1dc77e5f0f5ad2612ff,328,25,330,1,684,Chattahoocheee1d8a38e074337775565bdb78b5c22794feb548ee246c1dc77e5f0f5ad2612ff
Clay,e1d8a38e074337775565bdb78b5c22794feb548ee246c1dc77e5f0f5ad2612ff,398,72,318,1,789,Claye1d8a38e074337775565bdb78b5c22794feb548ee246c1dc77e5f0f5ad2612ff
Crawford,e1d8a38e074337775565bdb78b5c22794feb548ee246c1dc77e5f0f5ad2612ff,794,127,957,2,1880,Crawforde1d8a38e074337775565bdb78b5c22794feb548ee246c1dc77e5f0f5ad2612ff
Crisp,e1d8a38e074337775565bdb78b5c22794feb548ee246c1dc77e5f0f5ad2612ff,1237,165,2118,3,3523,Crispe1d8a38e074337775565bdb78b5c22794feb548ee246c1dc77e5f0f5ad2612ff
Decatur,e1d8a38e074337775565bdb78b5c22794feb548ee246c1dc77e5f0f5ad2612ff,2072,290,2521,20,4903,Decature1d8a38e074337775565bdb78b5c22794feb548ee246c1dc77e5f0f5ad2612ff
Dooly,e1d8a38e074337775565bdb78b5c22794feb548ee246c1dc77e5f0f5ad2612ff,1112,128,919,13,2172,Doolye1d8a38e074337775565bdb78b5c22794feb548ee246c1dc77e5f0f5ad2612ff
Dougherty,e1d8a38e074337775565bdb78b5c22794feb548ee246c1dc77e5f0f5ad2612ff,12314,1111,10508,79,24012,Doughertye1d8a38e074337775565bdb78b5c22794feb548ee246c1dc77e5f0f5ad2612ff
Early,e1d8a38e074337775565bdb78b5c22794feb548ee246c1dc77e5f0f5ad2612ff,1335,254,1149,1,2739,Earlye1d8a38e074337775565bdb78b5c22794feb548ee246c1dc77e5f0f5ad2612ff
Grady,e1d8a38e074337775565bdb78b5c22794feb548ee246c1dc77e5f0f5ad2612ff,1674,148,2237,9,4068,Gradye1d8a38e074337775565bdb78b5c22794feb548ee246c1dc77e5f0f5ad2612ff
Lee,e1d8a38e074337775565bdb78b5c22794feb548ee246c1dc77e5f0f5ad2612ff,1960,184,1947,2,4093,Leee1d8a38e074337775565bdb78b5c22794feb548ee246c1dc77e5f0f5ad2612ff
Macon,e1d8a38e074337775565bdb78b5c22794feb548ee246c1dc77e5f0f5ad2612ff,1312,188,1363,0,2863,Macone1d8a38e074337775565bdb78b5c22794feb548ee246c1dc77e5f0f5ad2612ff
Marion,e1d8a38e074337775565bdb78b5c22794feb548ee246c1dc77e5f0f5ad2612ff,679,204,631,0,1514,Marione1d8a38e074337775565bdb78b5c22794feb548ee246c1dc77e5f0f5ad2612ff
Miller,e1d8a38e074337775565bdb78b5c22794feb548ee246c1dc77e5f0f5ad2612ff,477,60,373,2,912,Millere1d8a38e074337775565bdb78b5c22794feb548ee246c1dc77e5f0f5ad2612ff
Mitchell,e1d8a38e074337775565bdb78b5c22794feb548ee246c1dc77e5f0f5ad2612ff,1846,420,1971,3,4240,Mitchelle1d8a38e074337775565bdb78b5c22794feb548ee246c1dc77e5f0f5ad2612ff
Muscogee,e1d8a38e074337775565bdb78b5c22794feb548ee246c1dc77e5f0f5ad2612ff,14750,1811,18056,79,34696,Muscogeee1d8a38e074337775565bdb78b5c22794feb548ee246c1dc77e5f0f5ad2612ff
Peach,e1d8a38e074337775565bdb78b5c22794feb548ee246c1dc77e5f0f5ad2612ff,1749,205,3484,18,5456,Peache1d8a38e074337775565bdb78b5c22794feb548ee246c1dc77e5f0f5ad2612ff
Quitman,e1d8a38e074337775565bdb78b5c22794feb548ee246c1dc77e5f0f5ad2612ff,287,23,259,0,569,Quitmane1d8a38e074337775565bdb78b5c22794feb548ee246c1dc77e5f0f5ad2612ff
Randolph,e1d8a38e074337775565bdb78b5c22794feb548ee246c1dc77e5f0f5ad2612ff,929,162,806,1,1898,Randolphe1d8a38e074337775565bdb78b5c22794feb548ee246c1dc77e5f0f5ad2612ff
Schley,e1d8a38e074337775565bdb78b5c22794feb548ee246c1dc77e5f0f5ad2612ff,212,45,344,0,601,Schleye1d8a38e074337775565bdb78b5c22794feb548ee246c1dc77e5f0f5ad2612ff
Seminole,e1d8a38e074337775565bdb78b5c22794feb548ee246c1dc77e5f0f5ad2612ff,867,79,568,3,1517,Seminolee1d8a38e074337775565bdb78b5c22794feb548ee246c1dc77e5f0f5ad2612ff
Stewart,e1d8a38e074337775565bdb78b5c22794feb548ee246c1dc77e5f0f5ad2612ff,695,261,496,3,1455,Stewarte1d8a38e074337775565bdb78b5c22794feb548ee246c1dc77e5f0f5ad2612ff
Sumter,e1d8a38e074337775565bdb78b5c22794feb548ee246c1dc77e5f0f5ad2612ff,2519,489,3284,0,6292,Sumtere1d8a38e074337775565bdb78b5c22794feb548ee246c1dc77e5f0f5ad2612ff
Talbot,e1d8a38e074337775565bdb78b5c22794feb548ee246c1dc77e5f0f5ad2612ff,1118,455,510,0,2083,Talbote1d8a38e074337775565bdb78b5c22794feb548ee246c1dc77e5f0f5ad2612ff
Taylor,e1d8a38e074337775565bdb78b5c22794feb548ee246c1dc77e5f0f5ad2612ff,752,194,664,0,1610,Taylore1d8a38e074337775565bdb78b5c22794feb548ee246c1dc77e5f0f5ad2612ff
Terrell,e1d8a38e074337775565bdb78b5c22794feb548ee246c1dc77e5f0f5ad2612ff,1234,190,1161,0,2585,Terrelle1d8a38e074337775565bdb78b5c22794feb548ee246c1dc77e5f0f5ad2612ff
Webster,e1d8a38e074337775565bdb78b5c22794feb548ee246c1dc77e5f0f5ad2612ff,290,76,213,1,580,Webstere1d8a38e074337775565bdb78b5c22794feb548ee246c1dc77e5f0f5ad2612ff
Carroll,dd1c98d08ed467f11cf8884a6e5b8ef5915f69a2a3d11aadf0200b4fb2b3c898,13298,923,16264,53,30538,Carrolldd1c98d08ed467f11cf8884a6e5b8ef5915f69a2a3d11aadf0200b4fb2b3c898
Coweta,dd1c98d08ed467f11cf8884a6e5b8ef5915f69a2a3d11aadf0200b4fb2b3c898,19827,2064,22588,14,44493,Cowetadd1c98d08ed467f11cf8884a6e5b8ef5915f69a2a3d11aadf0200b4fb2b3c898
Fayette,dd1c98d08ed467f11cf8884a6e5b8ef5915f69a2a3d11aadf0200b4fb2b3c898,10490,1586,21160,6,33242,Fayettedd1c98d08ed467f11cf8884a6e5b8ef5915f69a2a3d11aadf0200b4fb2b3c898
Harris,dd1c98d08ed467f11cf8884a6e5b8ef5915f69a2a3d11aadf0200b4fb2b3c898,5212,487,6601,1,12301,Harrisdd1c98d08ed467f11cf8884a6e5b8ef5915f69a2a3d11aadf0200b4fb2b3c898
Heard,dd1c98d08ed467f11cf8884a6e5b8ef5915f69a2a3d11aadf0200b4fb2b3c898,1783,194,1309,1,3287,Hearddd1c98d08ed467f11cf8884a6e5b8ef5915f69a2a3d11aadf0200b4fb2b3c898
Henry,dd1c98d08ed467f11cf8884a6e5b8ef5915f69a2a3d11aadf0200b4fb2b3c898,3179,532,9579,14,13304,Henrydd1c98d08ed467f11cf8884a6e5b8ef5915f69a2a3d11aadf0200b4fb2b3c898
Lamar,dd1c98d08ed467f11cf8884a6e5b8ef5915f69a2a3d11aadf0200b4fb2b3c898,2002,221,2920,7,5150,Lamardd1c98d08ed467f11cf8884a6e5b8ef5915f69a2a3d11aadf0200b4fb2b3c898
Meriwether,dd1c98d08ed467f11cf8884a6e5b8ef5915f69a2a3d11aadf0200b4fb2b3c898,2984,204,2044,2,5234,Meriwetherdd1c98d08ed467f11cf8884a6e5b8ef5915f69a2a3d11aadf0200b4fb2b3c898
Muscogee,dd1c98d08ed467f11cf8884a6e5b8ef5915f69a2a3d11aadf0200b4fb2b3c898,6582,770,5673,4,13029,Muscogeedd1c98d08ed467f11cf8884a6e5b8ef5915f69a2a3d11aadf0200b4fb2b3c898
Pike,dd1c98d08ed467f11cf8884a6e5b8ef5915f69a2a3d11aadf0200b4fb2b3c898,2648,297,4263,5,7213,Pikedd1c98d08ed467f11cf8884a6e5b8ef5915f69a2a3d11aadf0200b4fb2b3c898
Spalding,dd1c98d08ed467f11cf8884a6e5b8ef5915f69a2a3d11aadf0200b4fb2b3c898,5609,635,9454,8,15706,Spaldingdd1c98d08ed467f11cf8884a6e5b8ef5915f69a2a3d11aadf0200b4fb2b3c898
Troup,dd1c98d08ed467f11cf8884a6e5b8ef5915f69a2a3d11aadf0200b4fb2b3c898,7171,761,8449,116,16497,Troupdd1c98d08ed467f11cf8884a6e5b8ef5915f69a2a3d11aadf0200b4fb2b3c898
Upson,dd1c98d08ed467f11cf8884a6e5b8ef5915f69a2a3d11aadf0200b4fb2b3c898,1755,314,5152,3,7224,Upsondd1c98d08ed467f11cf8884a6e5b8ef5915f69a2a3d11aadf0200b4fb2b3c898
Carroll,1f1cf050b9f978935c1fd7e43335ad924d9193a40a6f914a49ed71db5bb3d583,4913,509,6649,33,12104,Carroll1f1cf050b9f978935c1fd7e43335ad924d9193a40a6f914a49ed71db5bb3d583
Coweta,1f1cf050b9f978935c1fd7e43335ad924d9193a40a6f914a49ed71db5bb3d583,6916,801,7844,6,15567,Coweta1f1cf050b9f978935c1fd7e43335ad924d9193a40a6f914a49ed71db5bb3d583
Fayette,1f1cf050b9f978935c1fd7e43335ad924d9193a40a6f914a49ed71db5bb3d583,4460,776,10346,7,15589,Fayette1f1cf050b9f978935c1fd7e43335ad924d9193a40a6f914a49ed71db5bb3d583
Harris,1f1cf050b9f978935c1fd7e43335ad924d9193a40a6f914a49ed71db5bb3d583,1585,209,1925,0,3719,Harris1f1cf050b9f978935c1fd7e43335ad924d9193a40a6f914a49ed71db5bb3d583
Heard,1f1cf050b9f978935c1fd7e43335ad924d9193a40a6f914a49ed71db5bb3d583,355,70,315,1,741,Heard1f1cf050b9f978935c1fd7e43335ad924d9193a40a6f914a49ed71db5bb3d583
Henry,1f1cf050b9f978935c1fd7e43335ad924d9193a40a6f914a49ed71db5bb3d583,4394,549,9916,16,14875,Henry1f1cf050b9f978935c1fd7e43335ad924d9193a40a6f914a49ed71db5bb3d583
Lamar,1f1cf050b9f978935c1fd7e43335ad924d9193a40a6f914a49ed71db5bb3d583,835,133,1204,4,2176,Lamar1f1cf050b9f978935c1fd7e43335ad924d9193a40a6f914a49ed71db5bb3d583
Meriwether,1f1cf050b9f978935c1fd7e43335ad924d9193a40a6f914a49ed71db5bb3d583,2089,194,1248,3,3534,Meriwether1f1cf050b9f978935c1fd7e43335ad924d9193a40a6f914a49ed71db5bb3d583
Muscogee,1f1cf050b9f978935c1fd7e43335ad924d9193a40a6f914a49ed71db5bb3d583,2536,387,2873,3,5799,Muscogee1f1cf050b9f978935c1fd7e43335ad924d9193a40a6f914a49ed71db5bb3d583
Pike,1f1cf050b9f978935c1fd7e43335ad924d9193a40a6f914a49ed71db5bb3d583,454,66,658,1,1179,Pike1f1cf050b9f978935c1fd7e43335ad924d9193a40a6f914a49ed71db5bb3d583
Spalding,1f1cf050b9f978935c1fd7e43335ad924d9193a40a6f914a49ed71db5bb3d583,3510,401,4763,7,8681,Spalding1f1cf050b9f978935c1fd7e43335ad924d9193a40a6f914a49ed71db5bb3d583
Troup,1f1cf050b9f978935c1fd7e43335ad924d9193a40a6f914a49ed71db5bb3d583,4326,481,3885,107,8799,Troup1f1cf050b9f978935c1fd7e43335ad924d9193a40a6f914a49ed71db5bb3d583
Upson,1f1cf050b9f978935c1fd7e43335ad924d9193a40a6f914a49ed71db5bb3d583,1147,139,1916,4,3206,Upson1f1cf050b9f978935c1fd7e43335ad924d9193a40a6f914a49ed71db5bb3d583
DeKalb,a7d811379bfac3e7ea689a17e37c0e5b6c233582b4e3383fa96328613574bb24,8692,1434,8628,17,18771,DeKalba7d811379bfac3e7ea689a17e37c0e5b6c233582b4e3383fa96328613574bb24
Gwinnett,a7d811379bfac3e7ea689a17e37c0e5b6c233582b4e3383fa96328613574bb24,11580,2044,11901,38,25563,Gwinnetta7d811379bfac3e7ea689a17e37c0e5b6c233582b4e3383fa96328613574bb24
Newton,a7d811379bfac3e7ea689a17e37c0e5b6c233582b4e3383fa96328613574bb24,5702,635,6274,0,12611,Newtona7d811379bfac3e7ea689a17e37c0e5b6c233582b4e3383fa96328613574bb24
Rockdale,a7d811379bfac3e7ea689a17e37c0e5b6c233582b4e3383fa96328613574bb24,3798,642,9202,6,13648,Rockdalea7d811379bfac3e7ea689a17e37c0e5b6c233582b4e3383fa96328613574bb24
DeKalb,09a6928fddfbbae0bcf13495264c26c21974f9608ec0372411f81074ca82e746,47059,5421,84071,191,136742,DeKalb09a6928fddfbbae0bcf13495264c26c21974f9608ec0372411f81074ca82e746
Gwinnett,09a6928fddfbbae0bcf13495264c26c21974f9608ec0372411f81074ca82e746,16752,1538,21958,195,40443,Gwinnett09a6928fddfbbae0bcf13495264c26c21974f9608ec0372411f81074ca82e746
Newton,09a6928fddfbbae0bcf13495264c26c21974f9608ec0372411f81074ca82e746,7948,907,10939,3,19797,Newton09a6928fddfbbae0bcf13495264c26c21974f9608ec0372411f81074ca82e746
Rockdale,09a6928fddfbbae0bcf13495264c26c21974f9608ec0372411f81074ca82e746,6300,780,16061,23,23164,Rockdale09a6928fddfbbae0bcf13495264c26c21974f9608ec0372411f81074ca82e746
Clayton,69a538b9569759712f55ef6ee1400d021280fe04876f694122e5d317e5a81d3a,1625,298,2381,10,4314,Clayton69a538b9569759712f55ef6ee1400d021280fe04876f694122e5d317e5a81d3a
DeKalb,69a538b9569759712f55ef6ee1400d021280fe04876f694122e5d317e5a81d3a,5685,649,4110,4,10448,DeKalb69a538b9569759712f55ef6ee1400d021280fe04876f694122e5d317e5a81d3a
Fulton,69a538b9569759712f55ef6ee1400d021280fe04876f694122e5d317e5a81d3a,15884,1656,14395,71,32006,Fulton69a538b9569759712f55ef6ee1400d021280fe04876f694122e5d317e5a81d3a
Clayton,78a3bbf5368dbd9afd1e1eccf54333b9d9a9b2d4932a9171629a85b1255d0abd,10674,747,15485,35,26941,Clayton78a3bbf5368dbd9afd1e1eccf54333b9d9a9b2d4932a9171629a85b1255d0abd
DeKalb,78a3bbf5368dbd9afd1e1eccf54333b9d9a9b2d4932a9171629a85b1255d0abd,25909,3440,37869,77,67295,DeKalb78a3bbf5368dbd9afd1e1eccf54333b9d9a9b2d4932a9171629a85b1255d0abd
Fulton,78a3bbf5368dbd9afd1e1eccf54333b9d9a9b2d4932a9171629a85b1255d0abd,65417,7024,86528,576,159545,Fulton78a3bbf5368dbd9afd1e1eccf54333b9d9a9b2d4932a9171629a85b1255d0abd
Cobb,d08b2c8cdc10385b8afa5900092174a7dc2326fd52663a517646f4867258c869,37966,6066,21435,79,65546,Cobbd08b2c8cdc10385b8afa5900092174a7dc2326fd52663a517646f4867258c869
DeKalb,d08b2c8cdc10385b8afa5900092174a7dc2326fd52663a517646f4867258c869,16442,2700,18712,25,37879,DeKalbd08b2c8cdc10385b8afa5900092174a7dc2326fd52663a517646f4867258c869
Fulton,d08b2c8cdc10385b8afa5900092174a7dc2326fd52663a517646f4867258c869,30638,6329,60573,123,97663,Fultond08b2c8cdc10385b8afa5900092174a7dc2326fd52663a517646f4867258c869
Cobb,24148a91b7828500a0af7667d9a185b67be2f52019550de6774cd5441d408ee6,16285,2462,13119,50,31916,Cobb24148a91b7828500a0af7667d9a185b67be2f52019550de6774cd5441d408ee6
DeKalb,24148a91b7828500a0af7667d9a185b67be2f52019550de6774cd5441d408ee6,12476,2033,19787,30,34326,DeKalb24148a91b7828500a0af7667d9a185b67be2f52019550de6774cd5441d408ee6
Fulton,24148a91b7828500a0af7667d9a185b67be2f52019550de6774cd5441d408ee6,15926,3107,39529,113,58675,Fulton24148a91b7828500a0af7667d9a185b67be2f52019550de6774cd5441d408ee6
Forsyth,785da998100a262984ea26fe53554f17d7301f0943fae6fd1171a209be8864b7,13471,2241,38156,16,53884,Forsyth785da998100a262984ea26fe53554f17d7301f0943fae6fd1171a209be8864b7
Gwinnett,785da998100a262984ea26fe53554f17d7301f0943fae6fd1171a209be8864b7,62833,8589,48392,383,120197,Gwinnett785da998100a262984ea26fe53554f17d7301f0943fae6fd1171a209be8864b7
Forsyth,d692eb5362b94d1173869a609a64b5966018290a74f4d5341ae8f5135db4427b,3971,771,10083,6,14831,Forsythd692eb5362b94d1173869a609a64b5966018290a74f4d5341ae8f5135db4427b
Gwinnett,d692eb5362b94d1173869a609a64b5966018290a74f4d5341ae8f5135db4427b,48120,4269,46448,552,99389,Gwinnettd692eb5362b94d1173869a609a64b5966018290a74f4d5341ae8f5135db4427b
Atkinson,cf942ce49597a69ddf52039144af020824af3b99cd48953a11a768a2b9df5ca0,760,65,887,6,1718,Atkinsoncf942ce49597a69ddf52039144af020824af3b99cd48953a11a768a2b9df5ca0
Ben Hill,cf942ce49597a69ddf52039144af020824af3b99cd48953a11a768a2b9df5ca0,938,129,2735,5,3807,Ben Hillcf942ce49597a69ddf52039144af020824af3b99cd48953a11a768a2b9df5ca0
Berrien,cf942ce49597a69ddf52039144af020824af3b99cd48953a11a768a2b9df5ca0,2334,292,2732,14,5372,Berriencf942ce49597a69ddf52039144af020824af3b99cd48953a11a768a2b9df5ca0
Bibb,cf942ce49597a69ddf52039144af020824af3b99cd48953a11a768a2b9df5ca0,7231,924,5255,12,13422,Bibbcf942ce49597a69ddf52039144af020824af3b99cd48953a11a768a2b9df5ca0
Bleckley,cf942ce49597a69ddf52039144af020824af3b99cd48953a11a768a2b9df5ca0,1551,140,2135,3,3829,Bleckleycf942ce49597a69ddf52039144af020824af3b99cd48953a11a768a2b9df5ca0
Brooks,cf942ce49597a69ddf52039144af020824af3b99cd48953a11a768a2b9df5ca0,1769,165,1750,21,3705,Brookscf942ce49597a69ddf52039144af020824af3b99cd48953a11a768a2b9df5ca0
Colquitt,cf942ce49597a69ddf52039144af020824af3b99cd48953a11a768a2b9df5ca0,5068,297,4752,5,10122,Colquittcf942ce49597a69ddf52039144af020824af3b99cd48953a11a768a2b9df5ca0
Cook,cf942ce49597a69ddf52039144af020824af3b99cd48953a11a768a2b9df5ca0,1660,158,2470,0,4288,Cookcf942ce49597a69ddf52039144af020824af3b99cd48953a11a768a2b9df5ca0
Dodge,cf942ce49597a69ddf52039144af020824af3b99cd48953a11a768a2b9df5ca0,2695,247,2055,0,4997,Dodgecf942ce49597a69ddf52039144af020824af3b99cd48953a11a768a2b9df5ca0
Houston,cf942ce49597a69ddf52039144af020824af3b99cd48953a11a768a2b9df5ca0,11375,1636,24576,59,37646,Houstoncf942ce49597a69ddf52039144af020824af3b99cd48953a11a768a2b9df5ca0
Irwin,cf942ce49597a69ddf52039144af020824af3b99cd48953a11a768a2b9df5ca0,1291,88,1345,5,2729,Irwincf942ce49597a69ddf52039144af020824af3b99cd48953a11a768a2b9df5ca0
Jones,cf942ce49597a69ddf52039144af020824af3b99cd48953a11a768a2b9df5ca0,3122,425,4892,1,8440,Jonescf942ce49597a69ddf52039144af020824af3b99cd48953a11a768a2b9df5ca0
Lanier,cf942ce49597a69ddf52039144af020824af3b99cd48953a11a768a2b9df5ca0,785,50,1115,0,1950,Laniercf942ce49597a69ddf52039144af020824af3b99cd48953a11a768a2b9df5ca0
Lowndes,cf942ce49597a69ddf52039144af020824af3b99cd48953a11a768a2b9df5ca0,6434,827,13887,202,21350,Lowndescf942ce49597a69ddf52039144af020824af3b99cd48953a11a768a2b9df5ca0
Monroe,cf942ce49597a69ddf52039144af020824af3b99cd48953a11a768a2b9df5ca0,4265,329,4494,9,9097,Monroecf942ce49597a69ddf52039144af020824af3b99cd48953a11a768a2b9df5ca0
Pulaski,cf942ce49597a69ddf52039144af020824af3b99cd48953a11a768a2b9df5ca0,561,122,1808,1,2492,Pulaskicf942ce49597a69ddf52039144af020824af3b99cd48953a11a768a2b9df5ca0
Telfair,cf942ce49597a69ddf52039144af020824af3b99cd48953a11a768a2b9df5ca0,1221,117,965,1,2304,Telfaircf942ce49597a69ddf52039144af020824af3b99cd48953a11a768a2b9df5ca0
Thomas,cf942ce49597a69ddf52039144af020824af3b99cd48953a11a768a2b9df5ca0,4408,479,6641,4,11532,Thomascf942ce49597a69ddf52039144af020824af3b99cd48953a11a768a2b9df5ca0
Tift,cf942ce49597a69ddf52039144af020824af3b99cd48953a11a768a2b9df5ca0,3953,400,5986,9,10348,Tiftcf942ce49597a69ddf52039144af020824af3b99cd48953a11a768a2b9df5ca0
Turner,cf942ce49597a69ddf52039144af020824af3b99cd48953a11a768a2b9df5ca0,698,58,1522,1,2279,Turnercf942ce49597a69ddf52039144af020824af3b99cd48953a11a768a2b9df5ca0
Twiggs,cf942ce49597a69ddf52039144af020824af3b99cd48953a11a768a2b9df5ca0,1122,98,781,1,2002,Twiggscf942ce49597a69ddf52039144af020824af3b99cd48953a11a768a2b9df5ca0
Wilcox,cf942ce49597a69ddf52039144af020824af3b99cd48953a11a768a2b9df5ca0,1001,177,936,0,2114,Wilcoxcf942ce49597a69ddf52039144af020824af3b99cd48953a11a768a2b9df5ca0
Wilkinson,cf942ce49597a69ddf52039144af020824af3b99cd48953a11a768a2b9df5ca0,1456,88,766,1,2311,Wilkinsoncf942ce49597a69ddf52039144af020824af3b99cd48953a11a768a2b9df5ca0
Worth,cf942ce49597a69ddf52039144af020824af3b99cd48953a11a768a2b9df5ca0,3393,180,2548,8,6129,Worthcf942ce49597a69ddf52039144af020824af3b99cd48953a11a768a2b9df5ca0
Atkinson,ffc04b653014135d946ebc550d1d861a077fcb4b4322d029d0b60adab5decc84,340,21,277,0,638,Atkinsonffc04b653014135d946ebc550d1d861a077fcb4b4322d029d0b60adab5decc84
Ben Hill,ffc04b653014135d946ebc550d1d861a077fcb4b4322d029d0b60adab5decc84,600,111,1176,3,1890,Ben Hillffc04b653014135d946ebc550d1d861a077fcb4b4322d029d0b60adab5decc84
Berrien,ffc04b653014135d946ebc550d1d861a077fcb4b4322d029d0b60adab5decc84,478,80,435,6,999,Berrienffc04b653014135d946ebc550d1d861a077fcb4b4322d029d0b60adab5decc84
Bibb,ffc04b653014135d946ebc550d1d861a077fcb4b4322d029d0b60adab5decc84,3446,417,3836,20,7719,Bibbffc04b653014135d946ebc550d1d861a077fcb4b4322d029d0b60adab5decc84
Bleckley,ffc04b653014135d946ebc550d1d861a077fcb4b4322d029d0b60adab5decc84,446,104,460,4,1014,Bleckleyffc04b653014135d946ebc550d1d861a077fcb4b4322d029d0b60adab5decc84
Brooks,ffc04b653014135d946ebc550d1d861a077fcb4b4322d029d0b60adab5decc84,949,433,909,27,2318,Brooksffc04b653014135d946ebc550d1d861a077fcb4b4322d029d0b60adab5decc84
Colquitt,ffc04b653014135d946ebc550d1d861a077fcb4b4322d029d0b60adab5decc84,1490,155,1318,1,2964,Colquittffc04b653014135d946ebc550d1d861a077fcb4b4322d029d0b60adab5decc84
Cook,ffc04b653014135d946ebc550d1d861a077fcb4b4322d029d0b60adab5decc84,789,64,703,0,1556,Cookffc04b653014135d946ebc550d1d861a077fcb4b4322d029d0b60adab5decc84
Dodge,ffc04b653014135d946ebc550d1d861a077fcb4b4322d029d0b60adab5decc84,834,87,706,0,1627,Dodgeffc04b653014135d946ebc550d1d861a077fcb4b4322d029d0b60adab5decc84
Houston,ffc04b653014135d946ebc550d1d861a077fcb4b4322d029d0b60adab5decc84,7010,960,12847,69,20886,Houstonffc04b653014135d946ebc550d1d861a077fcb4b4322d029d0b60adab5decc84
Irwin,ffc04b653014135d946ebc550d1d861a077fcb4b4322d029d0b60adab5decc84,363,34,419,0,816,Irwinffc04b653014135d946ebc550d1d861a077fcb4b4322d029d0b60adab5decc84
Jones,ffc04b653014135d946ebc550d1d861a077fcb4b4322d029d0b60adab5decc84,1345,301,2072,0,3718,Jonesffc04b653014135d946ebc550d1d861a077fcb4b4322d029d0b60adab5decc84
Lanier,ffc04b653014135d946ebc550d1d861a077fcb4b4322d029d0b60adab5decc84,308,23,403,1,735,Lanierffc04b653014135d946ebc550d1d861a077fcb4b4322d029d0b60adab5decc84
Lowndes,ffc04b653014135d946ebc550d1d861a077fcb4b4322d029d0b60adab5decc84,4113,619,8858,278,13868,Lowndesffc04b653014135d946ebc550d1d861a077fcb4b4322d029d0b60adab5decc84
Monroe,ffc04b653014135d946ebc550d1d861a077fcb4b4322d029d0b60adab5decc84,1288,218,1709,1,3216,Monroeffc04b653014135d946ebc550d1d861a077fcb4b4322d029d0b60adab5decc84
Pulaski,ffc04b653014135d946ebc550d1d861a077fcb4b4322d029d0b60adab5decc84,285,76,556,0,917,Pulaskiffc04b653014135d946ebc550d1d861a077fcb4b4322d029d0b60adab5decc84
Telfair,ffc04b653014135d946ebc550d1d861a077fcb4b4322d029d0b60adab5decc84,609,211,394,0,1214,Telfairffc04b653014135d946ebc550d1d861a077fcb4b4322d029d0b60adab5decc84
Thomas,ffc04b653014135d946ebc550d1d861a077fcb4b4322d029d0b60adab5decc84,2590,368,3585,1,6544,Thomasffc04b653014135d946ebc550d1d861a077fcb4b4322d029d0b60adab5decc84
Tift,ffc04b653014135d946ebc550d1d861a077fcb4b4322d029d0b60adab5decc84,1409,146,1895,6,3456,Tiftffc04b653014135d946ebc550d1d861a077fcb4b4322d029d0b60adab5decc84
Turner,ffc04b653014135d946ebc550d1d861a077fcb4b4322d029d0b60adab5decc84,459,26,542,2,1029,Turnerffc04b653014135d946ebc550d1d861a077fcb4b4322d029d0b60adab5decc84
Twiggs,ffc04b653014135d946ebc550d1d861a077fcb4b4322d029d0b60adab5decc84,879,217,704,0,1800,Twiggsffc04b653014135d946ebc550d1d861a077fcb4b4322d029d0b60adab5decc84
Wilcox,ffc04b653014135d946ebc550d1d861a077fcb4b4322d029d0b60adab5decc84,471,33,215,0,719,Wilcoxffc04b653014135d946ebc550d1d861a077fcb4b4322d029d0b60adab5decc84
Wilkinson,ffc04b653014135d946ebc550d1d861a077fcb4b4322d029d0b60adab5decc84,900,121,664,2,1687,Wilkinsonffc04b653014135d946ebc550d1d861a077fcb4b4322d029d0b60adab5decc84
Worth,ffc04b653014135d946ebc550d1d861a077fcb4b4322d029d0b60adab5decc84,934,95,864,2,1895,Worthffc04b653014135d946ebc550d1d861a077fcb4b4322d029d0b60adab5decc84
Banks,3bb7f9202a8b0fa3cf0cfc0664154c5b68d2dcee1c5e67d5c7151d336ff27acb,3169,190,2904,1,6264,Banks3bb7f9202a8b0fa3cf0cfc0664154c5b68d2dcee1c5e67d5c7151d336ff27acb
Clarke,3bb7f9202a8b0fa3cf0cfc0664154c5b68d2dcee1c5e67d5c7151d336ff27acb,1555,152,1204,2,2913,Clarke3bb7f9202a8b0fa3cf0cfc0664154c5b68d2dcee1c5e67d5c7151d336ff27acb
Dawson,3bb7f9202a8b0fa3cf0cfc0664154c5b68d2dcee1c5e67d5c7151d336ff27acb,2676,440,7233,15,10364,Dawson3bb7f9202a8b0fa3cf0cfc0664154c5b68d2dcee1c5e67d5c7151d336ff27acb
Elbert,3bb7f9202a8b0fa3cf0cfc0664154c5b68d2dcee1c5e67d5c7151d336ff27acb,2418,383,3653,46,6500,Elbert3bb7f9202a8b0fa3cf0cfc0664154c5b68d2dcee1c5e67d5c7151d336ff27acb
Fannin,3bb7f9202a8b0fa3cf0cfc0664154c5b68d2dcee1c5e67d5c7151d336ff27acb,4374,643,4928,6,9951,Fannin3bb7f9202a8b0fa3cf0cfc0664154c5b68d2dcee1c5e67d5c7151d336ff27acb
Forsyth,3bb7f9202a8b0fa3cf0cfc0664154c5b68d2dcee1c5e67d5c7151d336ff27acb,6926,729,16824,10,24489,Forsyth3bb7f9202a8b0fa3cf0cfc0664154c5b68d2dcee1c5e67d5c7151d336ff27acb
Franklin,3bb7f9202a8b0fa3cf0cfc0664154c5b68d2dcee1c5e67d5c7151d336ff27acb,3657,341,3571,0,7569,Franklin3bb7f9202a8b0fa3cf0cfc0664154c5b68d2dcee1c5e67d5c7151d336ff27acb
Gilmer,3bb7f9202a8b0fa3cf0cfc0664154c5b68d2dcee1c5e67d5c7151d336ff27acb,4513,539,5648,9,10709,Gilmer3bb7f9202a8b0fa3cf0cfc0664154c5b68d2dcee1c5e67d5c7151d336ff27acb
Habersham,3bb7f9202a8b0fa3cf0cfc0664154c5b68d2dcee1c5e67d5c7151d336ff27acb,2879,780,10357,3,14019,Habersham3bb7f9202a8b0fa3cf0cfc0664154c5b68d2dcee1c5e67d5c7151d336ff27acb
Hall,3bb7f9202a8b0fa3cf0cfc0664154c5b68d2dcee1c5e67d5c7151d336ff27acb,28292,2907,29288,55,60542,Hall3bb7f9202a8b0fa3cf0cfc0664154c5b68d2dcee1c5e67d5c7151d336ff27acb
Hart,3bb7f9202a8b0fa3cf0cfc0664154c5b68d2dcee1c5e67d5c7151d336ff27acb,3484,383,4329,0,8196,Hart3bb7f9202a8b0fa3cf0cfc0664154c5b68d2dcee1c5e67d5c7151d336ff27acb
Jackson,3bb7f9202a8b0fa3cf0cfc0664154c5b68d2dcee1c5e67d5c7151d336ff27acb,8822,688,14705,39,24254,Jackson3bb7f9202a8b0fa3cf0cfc0664154c5b68d2dcee1c5e67d5c7151d336ff27acb
Lumpkin,3bb7f9202a8b0fa3cf0cfc0664154c5b68d2dcee1c5e67d5c7151d336ff27acb,2540,446,7704,6,10696,Lumpkin3bb7f9202a8b0fa3cf0cfc0664154c5b68d2dcee1c5e67d5c7151d336ff27acb
Madison,3bb7f9202a8b0fa3cf0cfc0664154c5b68d2dcee1c5e67d5c7151d336ff27acb,4510,411,5229,6,10156,Madison3bb7f9202a8b0fa3cf0cfc0664154c5b68d2dcee1c5e67d5c7151d336ff27acb
Pickens,3bb7f9202a8b0fa3cf0cfc0664154c5b68d2dcee1c5e67d5c7151d336ff27acb,2819,158,4929,1,7907,Pickens3bb7f9202a8b0fa3cf0cfc0664154c5b68d2dcee1c5e67d5c7151d336ff27acb
Rabun,3bb7f9202a8b0fa3cf0cfc0664154c5b68d2dcee1c5e67d5c7151d336ff27acb,1194,757,4757,0,6708,Rabun3bb7f9202a8b0fa3cf0cfc0664154c5b68d2dcee1c5e67d5c7151d336ff27acb
Stephens,3bb7f9202a8b0fa3cf0cfc0664154c5b68d2dcee1c5e67d5c7151d336ff27acb,1775,555,6264,3,8597,Stephens3bb7f9202a8b0fa3cf0cfc0664154c5b68d2dcee1c5e67d5c7151d336ff27acb
Towns,3bb7f9202a8b0fa3cf0cfc0664154c5b68d2dcee1c5e67d5c7151d336ff27acb,1549,315,3781,10,5655,Towns3bb7f9202a8b0fa3cf0cfc0664154c5b68d2dcee1c5e67d5c7151d336ff27acb
Union,3bb7f9202a8b0fa3cf0cfc0664154c5b68d2dcee1c5e67d5c7151d336ff27acb,3513,525,6451,2,10491,Union3bb7f9202a8b0fa3cf0cfc0664154c5b68d2dcee1c5e67d5c7151d336ff27acb
White,3bb7f9202a8b0fa3cf0cfc0664154c5b68d2dcee1c5e67d5c7151d336ff27acb,4410,522,5612,11,10555,White3bb7f9202a8b0fa3cf0cfc0664154c5b68d2dcee1c5e67d5c7151d336ff27acb
Baldwin,4e59a47cded907a0ee0d5754da3a32bcc4fbc0dbab856ba7396e6e076b486248,4468,540,6096,6,11110,Baldwin4e59a47cded907a0ee0d5754da3a32bcc4fbc0dbab856ba7396e6e076b486248
Barrow,4e59a47cded907a0ee0d5754da3a32bcc4fbc0dbab856ba7396e6e076b486248,10807,936,12972,1,24716,Barrow4e59a47cded907a0ee0d5754da3a32bcc4fbc0dbab856ba7396e6e076b486248
Butts,4e59a47cded907a0ee0d5754da3a32bcc4fbc0dbab856ba7396e6e076b486248,2157,223,5398,0,7778,Butts4e59a47cded907a0ee0d5754da3a32bcc4fbc0dbab856ba7396e6e076b486248
Clarke,4e59a47cded907a0ee0d5754da3a32bcc4fbc0dbab856ba7396e6e076b486248,10577,1447,11545,37,23606,Clarke4e59a47cded907a0ee0d5754da3a32bcc4fbc0dbab856ba7396e6e076b486248
Columbia,4e59a47cded907a0ee0d5754da3a32bcc4fbc0dbab856ba7396e6e076b486248,3602,297,3655,3,7557,Columbia4e59a47cded907a0ee0d5754da3a32bcc4fbc0dbab856ba7396e6e076b486248
Glascock,4e59a47cded907a0ee0d5754da3a32bcc4fbc0dbab856ba7396e6e076b486248,506,48,577,0,1131,Glascock4e59a47cded907a0ee0d5754da3a32bcc4fbc0dbab856ba7396e6e076b486248
Greene,4e59a47cded907a0ee0d5754da3a32bcc4fbc0dbab856ba7396e6e076b486248,2028,402,4637,6,7073,Greene4e59a47cded907a0ee0d5754da3a32bcc4fbc0dbab856ba7396e6e076b486248
Gwinnett,4e59a47cded907a0ee0d5754da3a32bcc4fbc0dbab856ba7396e6e076b486248,11840,1348,12729,18,25935,Gwinnett4e59a47cded907a0ee0d5754da3a32bcc4fbc0dbab856ba7396e6e076b486248
Hancock,4e59a47cded907a0ee0d5754da3a32bcc4fbc0dbab856ba7396e6e076b486248,942,148,726,5,1821,Hancock4e59a47cded907a0ee0d5754da3a32bcc4fbc0dbab856ba7396e6e076b486248
Henry,4e59a47cded907a0ee0d5754da3a32bcc4fbc0dbab856ba7396e6e076b486248,5919,622,12664,6,19211,Henry4e59a47cded907a0ee0d5754da3a32bcc4fbc0dbab856ba7396e6e076b486248
Jasper,4e59a47cded907a0ee0d5754da3a32bcc4fbc0dbab856ba7396e6e076b486248,1970,273,2754,6,5003,Jasper4e59a47cded907a0ee0d5754da3a32bcc4fbc0dbab856ba7396e6e076b486248
Jefferson,4e59a47cded907a0ee0d5754da3a32bcc4fbc0dbab856ba7396e6e076b486248,2213,249,1828,11,4301,Jefferson4e59a47cded907a0ee0d5754da3a32bcc4fbc0dbab856ba7396e6e076b486248
Johnson,4e59a47cded907a0ee0d5754da3a32bcc4fbc0dbab856ba7396e6e076b486248,1086,165,1502,0,2753,Johnson4e59a47cded907a0ee0d5754da3a32bcc4fbc0dbab856ba7396e6e076b486248
Lincoln,4e59a47cded907a0ee0d5754da3a32bcc4fbc0dbab856ba7396e6e076b486248,1281,220,1648,1,3150,Lincoln4e59a47cded907a0ee0d5754da3a32bcc4fbc0dbab856ba7396e6e076b486248
McDuffie,4e59a47cded907a0ee0d5754da3a32bcc4fbc0dbab856ba7396e6e076b486248,2627,396,4011,0,7034,McDuffie4e59a47cded907a0ee0d5754da3a32bcc4fbc0dbab856ba7396e6e076b486248
Morgan,4e59a47cded907a0ee0d5754da3a32bcc4fbc0dbab856ba7396e6e076b486248,3024,309,4564,4,7901,Morgan4e59a47cded907a0ee0d5754da3a32bcc4fbc0dbab856ba7396e6e076b486248
Newton,4e59a47cded907a0ee0d5754da3a32bcc4fbc0dbab856ba7396e6e076b486248,5161,368,3271,0,8800,Newton4e59a47cded907a0ee0d5754da3a32bcc4fbc0dbab856ba7396e6e076b486248
Oconee,4e59a47cded907a0ee0d5754da3a32bcc4fbc0dbab856ba7396e6e076b486248,6459,651,9329,8,16447,Oconee4e59a47cded907a0ee0d5754da3a32bcc4fbc0dbab856ba7396e6e076b486248
Oglethorpe,4e59a47cded907a0ee0d5754da3a32bcc4fbc0dbab856ba7396e6e076b486248,1864,300,3126,2,5292,Oglethorpe4e59a47cded907a0ee0d5754da3a32bcc4fbc0dbab856ba7396e6e076b486248
Putnam,4e59a47cded907a0ee0d5754da3a32bcc4fbc0dbab856ba7396e6e076b486248,2861,461,4379,4,7705,Putnam4e59a47cded907a0ee0d5754da3a32bcc4fbc0dbab856ba7396e6e076b486248
Taliaferro,4e59a47cded907a0ee0d5754da3a32bcc4fbc0dbab856ba7396e6e076b486248,221,42,226,1,490,Taliaferro4e59a47cded907a0ee0d5754da3a32bcc4fbc0dbab856ba7396e6e076b486248
Walton,4e59a47cded907a0ee0d5754da3a32bcc4fbc0dbab856ba7396e6e076b486248,18021,1426,15246,34,34727,Walton4e59a47cded907a0ee0d5754da3a32bcc4fbc0dbab856ba7396e6e076b486248
Warren,4e59a47cded907a0ee0d5754da3a32bcc4fbc0dbab856ba7396e6e076b486248,588,97,797,1,1483,Warren4e59a47cded907a0ee0d5754da3a32bcc4fbc0dbab856ba7396e6e076b486248
Washington,4e59a47cded907a0ee0d5754da3a32bcc4fbc0dbab856ba7396e6e076b486248,2471,394,2707,19,5591,Washington4e59a47cded907a0ee0d5754da3a32bcc4fbc0dbab856ba7396e6e076b486248
Wilkes,4e59a47cded907a0ee0d5754da3a32bcc4fbc0dbab856ba7396e6e076b486248,1471,120,1513,6,3110,Wilkes4e59a47cded907a0ee0d5754da3a32bcc4fbc0dbab856ba7396e6e076b486248
Bartow,bdcda51984006d871b1581b4dc2eb1bff3a578941a63b68fe423871731f09d50,15857,1091,13373,20,30341,Bartowbdcda51984006d871b1581b4dc2eb1bff3a578941a63b68fe423871731f09d50
Cherokee,bdcda51984006d871b1581b4dc2eb1bff3a578941a63b68fe423871731f09d50,34441,3826,47058,17,85342,Cherokeebdcda51984006d871b1581b4dc2eb1bff3a578941a63b68fe423871731f09d50
Cobb,bdcda51984006d871b1581b4dc2eb1bff3a578941a63b68fe423871731f09d50,45210,6353,35328,122,87013,Cobbbdcda51984006d871b1581b4dc2eb1bff3a578941a63b68fe423871731f09d50
Fulton,bdcda51984006d871b1581b4dc2eb1bff3a578941a63b68fe423871731f09d50,5302,892,9029,16,15239,Fultonbdcda51984006d871b1581b4dc2eb1bff3a578941a63b68fe423871731f09d50
Bartow,52f4e6b4bf78b730ca12579f8d1355ee1314d0247993b86515270feee199f620,4002,411,3680,7,8100,Bartow52f4e6b4bf78b730ca12579f8d1355ee1314d0247993b86515270feee199f620
Cherokee,52f4e6b4bf78b730ca12579f8d1355ee1314d0247993b86515270feee199f620,9209,1369,12361,7,22946,Cherokee52f4e6b4bf78b730ca12579f8d1355ee1314d0247993b86515270feee199f620
Cobb,52f4e6b4bf78b730ca12579f8d1355ee1314d0247993b86515270feee199f620,30787,4028,31755,191,66761,Cobb52f4e6b4bf78b730ca12579f8d1355ee1314d0247993b86515270feee199f620
Fulton,52f4e6b4bf78b730ca12579f8d1355ee1314d0247993b86515270feee199f620,1905,668,4994,9,7576,Fulton52f4e6b4bf78b730ca12579f8d1355ee1314d0247993b86515270feee199f620
Appling,e0582b77c5f050627aa2e1faf516ac6068be69cdcc79a5e71790a882255d30b5,2885,371,2129,2,5387,Applinge0582b77c5f050627aa2e1faf516ac6068be69cdcc79a5e71790a882255d30b5
Bulloch,e0582b77c5f050627aa2e1faf516ac6068be69cdcc79a5e71790a882255d30b5,7787,656,7667,35,16145,Bulloche0582b77c5f050627aa2e1faf516ac6068be69cdcc79a5e71790a882255d30b5
Burke,e0582b77c5f050627aa2e1faf516ac6068be69cdcc79a5e71790a882255d30b5,2355,285,2048,0,4688,Burkee0582b77c5f050627aa2e1faf516ac6068be69cdcc79a5e71790a882255d30b5
Candler,e0582b77c5f050627aa2e1faf516ac6068be69cdcc79a5e71790a882255d30b5,595,90,1983,3,2671,Candlere0582b77c5f050627aa2e1faf516ac6068be69cdcc79a5e71790a882255d30b5
Coffee,e0582b77c5f050627aa2e1faf516ac6068be69cdcc79a5e71790a882255d30b5,2944,307,5925,0,9176,Coffeee0582b77c5f050627aa2e1faf516ac6068be69cdcc79a5e71790a882255d30b5
Columbia,e0582b77c5f050627aa2e1faf516ac6068be69cdcc79a5e71790a882255d30b5,15632,1849,22007,16,39504,Columbiae0582b77c5f050627aa2e1faf516ac6068be69cdcc79a5e71790a882255d30b5
Effingham,e0582b77c5f050627aa2e1faf516ac6068be69cdcc79a5e71790a882255d30b5,2692,167,3944,2,6805,Effinghame0582b77c5f050627aa2e1faf516ac6068be69cdcc79a5e71790a882255d30b5
Emanuel,e0582b77c5f050627aa2e1faf516ac6068be69cdcc79a5e71790a882255d30b5,2803,230,2331,5,5369,Emanuele0582b77c5f050627aa2e1faf516ac6068be69cdcc79a5e71790a882255d30b5
Evans,e0582b77c5f050627aa2e1faf516ac6068be69cdcc79a5e71790a882255d30b5,696,132,1609,0,2437,Evanse0582b77c5f050627aa2e1faf516ac6068be69cdcc79a5e71790a882255d30b5
Jeff Davis,e0582b77c5f050627aa2e1faf516ac6068be69cdcc79a5e71790a882255d30b5,1676,169,1998,2,3845,Jeff Davise0582b77c5f050627aa2e1faf516ac6068be69cdcc79a5e71790a882255d30b5
Jenkins,e0582b77c5f050627aa2e1faf516ac6068be69cdcc79a5e71790a882255d30b5,746,101,1060,3,1910,Jenkinse0582b77c5f050627aa2e1faf516ac6068be69cdcc79a5e71790a882255d30b5
Laurens,e0582b77c5f050627aa2e1faf516ac6068be69cdcc79a5e71790a882255d30b5,6477,678,5416,2,12573,Laurense0582b77c5f050627aa2e1faf516ac6068be69cdcc79a5e71790a882255d30b5
Montgomery,e0582b77c5f050627aa2e1faf516ac6068be69cdcc79a5e71790a882255d30b5,1563,86,974,0,2623,Montgomerye0582b77c5f050627aa2e1faf516ac6068be69cdcc79a5e71790a882255d30b5
Richmond,e0582b77c5f050627aa2e1faf516ac6068be69cdcc79a5e71790a882255d30b5,14158,1785,12196,22,28161,Richmonde0582b77c5f050627aa2e1faf516ac6068be69cdcc79a5e71790a882255d30b5
Screven,e0582b77c5f050627aa2e1faf516ac6068be69cdcc79a5e71790a882255d30b5,1530,105,1791,0,3426,Screvene0582b77c5f050627aa2e1faf516ac6068be69cdcc79a5e71790a882255d30b5
Tattnall,e0582b77c5f050627aa2e1faf516ac6068be69cdcc79a5e71790a882255d30b5,1907,449,2692,4,5052,Tattnalle0582b77c5f050627aa2e1faf516ac6068be69cdcc79a5e71790a882255d30b5
Toombs,e0582b77c5f050627aa2e1faf516ac6068be69cdcc79a5e71790a882255d30b5,2555,368,3664,2,6589,Toombse0582b77c5f050627aa2e1faf516ac6068be69cdcc79a5e71790a882255d30b5
Treutlen,e0582b77c5f050627aa2e1faf516ac6068be69cdcc79a5e71790a882255d30b5,584,110,1064,1,1759,Treutlene0582b77c5f050627aa2e1faf516ac6068be69cdcc79a5e71790a882255d30b5
Wheeler,e0582b77c5f050627aa2e1faf516ac6068be69cdcc79a5e71790a882255d30b5,641,99,631,1,1372,Wheelere0582b77c5f050627aa2e1faf516ac6068be69cdcc79a5e71790a882255d30b5
Appling,9eb62e0cf369a706f845757cdebc7b5b5171073462e28f06687d64299f46b22a,623,148,534,0,1305,Appling9eb62e0cf369a706f845757cdebc7b5b5171073462e28f06687d64299f46b22a
Bulloch,9eb62e0cf369a706f845757cdebc7b5b5171073462e28f06687d64299f46b22a,3653,378,4467,15,8513,Bulloch9eb62e0cf369a706f845757cdebc7b5b5171073462e28f06687d64299f46b22a
Burke,9eb62e0cf369a706f845757cdebc7b5b5171073462e28f06687d64299f46b22a,2272,633,1434,0,4339,Burke9eb62e0cf369a706f845757cdebc7b5b5171073462e28f06687d64299f46b22a
Candler,9eb62e0cf369a706f845757cdebc7b5b5171073462e28f06687d64299f46b22a,353,43,526,1,923,Candler9eb62e0cf369a706f845757cdebc7b5b5171073462e28f06687d64299f46b22a
Coffee,9eb62e0cf369a706f845757cdebc7b5b5171073462e28f06687d64299f46b22a,1508,153,2108,0,3769,Coffee9eb62e0cf369a706f845757cdebc7b5b5171073462e28f06687d64299f46b22a
Columbia,9eb62e0cf369a706f845757cdebc7b5b5171073462e28f06687d64299f46b22a,5858,932,8487,7,15284,Columbia9eb62e0cf369a706f845757cdebc7b5b5171073462e28f06687d64299f46b22a
Effingham,9eb62e0cf369a706f845757cdebc7b5b5171073462e28f06687d64299f46b22a,771,74,872,0,1717,Effingham9eb62e0cf369a706f845757cdebc7b5b5171073462e28f06687d64299f46b22a
Emanuel,9eb62e0cf369a706f845757cdebc7b5b5171073462e28f06687d64299f46b22a,1146,107,868,2,2123,Emanuel9eb62e0cf369a706f845757cdebc7b5b5171073462e28f06687d64299f46b22a
Evans,9eb62e0cf369a706f845757cdebc7b5b5171073462e28f06687d64299f46b22a,361,47,547,0,955,Evans9eb62e0cf369a706f845757cdebc7b5b5171073462e28f06687d64299f46b22a
Jeff Davis,9eb62e0cf369a706f845757cdebc7b5b5171073462e28f06687d64299f46b22a,441,31,357,0,829,Jeff Davis9eb62e0cf369a706f845757cdebc7b5b5171073462e28f06687d64299f46b22a
Jenkins,9eb62e0cf369a706f845757cdebc7b5b5171073462e28f06687d64299f46b22a,470,69,449,13,1001,Jenkins9eb62e0cf369a706f845757cdebc7b5b5171073462e28f06687d64299f46b22a
Laurens,9eb62e0cf369a706f845757cdebc7b5b5171073462e28f06687d64299f46b22a,2930,432,2694,1,6057,Laurens9eb62e0cf369a706f845757cdebc7b5b5171073462e28f06687d64299f46b22a
Montgomery,9eb62e0cf369a706f845757cdebc7b5b5171073462e28f06687d64299f46b22a,431,38,262,0,731,Montgomery9eb62e0cf369a706f845757cdebc7b5b5171073462e28f06687d64299f46b22a
Richmond,9eb62e0cf369a706f845757cdebc7b5b5171073462e28f06687d64299f46b22a,19895,2563,22484,81,45023,Richmond9eb62e0cf369a706f845757cdebc7b5b5171073462e28f06687d64299f46b22a
Screven,9eb62e0cf369a706f845757cdebc7b5b5171073462e28f06687d64299f46b22a,1109,76,859,0,2044,Screven9eb62e0cf369a706f845757cdebc7b5b5171073462e28f06687d64299f46b22a
Tattnall,9eb62e0cf369a706f845757cdebc7b5b5171073462e28f06687d64299f46b22a,615,107,718,2,1442,Tattnall9eb62e0cf369a706f845757cdebc7b5b5171073462e28f06687d64299f46b22a
Toombs,9eb62e0cf369a706f845757cdebc7b5b5171073462e28f06687d64299f46b22a,967,227,897,0,2091,Toombs9eb62e0cf369a706f845757cdebc7b5b5171073462e28f06687d64299f46b22a
Treutlen,9eb62e0cf369a706f845757cdebc7b5b5171073462e28f06687d64299f46b22a,259,49,396,2,706,Treutlen9eb62e0cf369a706f845757cdebc7b5b5171073462e28f06687d64299f46b22a
Wheeler,9eb62e0cf369a706f845757cdebc7b5b5171073462e28f06687d64299f46b22a,269,52,245,2,568,Wheeler9eb62e0cf369a706f845757cdebc7b5b5171073462e28f06687d64299f46b22a
Clayton,dd3dde7dda393cf6be441bf02d5b410681fe94539d7a19f1aa0227e32c49ccbd,19101,1679,34148,70,54998,Claytondd3dde7dda393cf6be441bf02d5b410681fe94539d7a19f1aa0227e32c49ccbd
Cobb,dd3dde7dda393cf6be441bf02d5b410681fe94539d7a19f1aa0227e32c49ccbd,26034,3046,29527,114,58721,Cobbdd3dde7dda393cf6be441bf02d5b410681fe94539d7a19f1aa0227e32c49ccbd
Douglas,dd3dde7dda393cf6be441bf02d5b410681fe94539d7a19f1aa0227e32c49ccbd,15235,1698,27167,30,44130,Douglasdd3dde7dda393cf6be441bf02d5b410681fe94539d7a19f1aa0227e32c49ccbd
Fayette,dd3dde7dda393cf6be441bf02d5b410681fe94539d7a19f1aa0227e32c49ccbd,2437,301,4991,5,7734,Fayettedd3dde7dda393cf6be441bf02d5b410681fe94539d7a19f1aa0227e32c49ccbd
Fulton,dd3dde7dda393cf6be441bf02d5b410681fe94539d7a19f1aa0227e32c49ccbd,14433,1284,35279,92,51088,Fultondd3dde7dda393cf6be441bf02d5b410681fe94539d7a19f1aa0227e32c49ccbd
Henry,dd3dde7dda393cf6be441bf02d5b410681fe94539d7a19f1aa0227e32c49ccbd,9380,1184,25534,64,36162,Henrydd3dde7dda393cf6be441bf02d5b410681fe94539d7a19f1aa0227e32c49ccbd
Catoosa,d45b767c509f35d96953cd17a4e6c8d2a64992aa0d6fb583daa0253abae21829,7980,556,14743,13,23292,Catoosad45b767c509f35d96953cd17a4e6c8d2a64992aa0d6fb583daa0253abae21829
Chattooga,d45b767c509f35d96953cd17a4e6c8d2a64992aa0d6fb583daa0253abae21829,3317,186,3592,4,7099,Chattoogad45b767c509f35d96953cd17a4e6c8d2a64992aa0d6fb583daa0253abae21829
Dade,d45b767c509f35d96953cd17a4e6c8d2a64992aa0d6fb583daa0253abae21829,2734,120,2436,1,5291,Daded45b767c509f35d96953cd17a4e6c8d2a64992aa0d6fb583daa0253abae21829
Floyd,d45b767c509f35d96953cd17a4e6c8d2a64992aa0d6fb583daa0253abae21829,12082,1033,15637,93,28845,Floydd45b767c509f35d96953cd17a4e6c8d2a64992aa0d6fb583daa0253abae21829
Gordon,d45b767c509f35d96953cd17a4e6c8d2a64992aa0d6fb583daa0253abae21829,7691,481,7861,20,16053,Gordond45b767c509f35d96953cd17a4e6c8d2a64992aa0d6fb583daa0253abae21829
Haralson,d45b767c509f35d96953cd17a4e6c8d2a64992aa0d6fb583daa0253abae21829,5067,379,4689,7,10142,Haralsond45b767c509f35d96953cd17a4e6c8d2a64992aa0d6fb583daa0253abae21829
Murray,d45b767c509f35d96953cd17a4e6c8d2a64992aa0d6fb583daa0253abae21829,5500,297,4872,0,10669,Murrayd45b767c509f35d96953cd17a4e6c8d2a64992aa0d6fb583daa0253abae21829
Paulding,d45b767c509f35d96953cd17a4e6c8d2a64992aa0d6fb583daa0253abae21829,15427,2437,34886,20,52770,Pauldingd45b767c509f35d96953cd17a4e6c8d2a64992aa0d6fb583daa0253abae21829
Pickens,d45b767c509f35d96953cd17a4e6c8d2a64992aa0d6fb583daa0253abae21829,1922,55,2216,0,4193,Pickensd45b767c509f35d96953cd17a4e6c8d2a64992aa0d6fb583daa0253abae21829
Polk,d45b767c509f35d96953cd17a4e6c8d2a64992aa0d6fb583daa0253abae21829,3899,407,7819,7,12132,Polkd45b767c509f35d96953cd17a4e6c8d2a64992aa0d6fb583daa0253abae21829
Walker,d45b767c509f35d96953cd17a4e6c8d2a64992aa0d6fb583daa0253abae21829,8349,802,11709,11,20871,Walkerd45b767c509f35d96953cd17a4e6c8d2a64992aa0d6fb583daa0253abae21829
Whitfield,d45b767c509f35d96953cd17a4e6c8d2a64992aa0d6fb583daa0253abae21829,13414,947,10995,30,25386,Whitfieldd45b767c509f35d96953cd17a4e6c8d2a64992aa0d6fb583daa0253abae21829
Bryan,b4b1610d77279c915def511f129df0dabe70c3fcb4583ac11c37fc59206c33e4,4766,378,7546,10,12700,Bryanb4b1610d77279c915def511f129df0dabe70c3fcb4583ac11c37fc59206c33e4
Chatham,b4b1610d77279c915def511f129df0dabe70c3fcb4583ac11c37fc59206c33e4,24844,1491,11447,39,37821,Chathamb4b1610d77279c915def511f129df0dabe70c3fcb4583ac11c37fc59206c33e4
Liberty,b4b1610d77279c915def511f129df0dabe70c3fcb4583ac11c37fc59206c33e4,3552,328,4728,22,8630,Libertyb4b1610d77279c915def511f129df0dabe70c3fcb4583ac11c37fc59206c33e4
Chatham,d7837ab7823ec849bae2e0679c31b106bd58e5e292c197ff35cc108160acda89,34640,2468,17098,58,54264,Chathamd7837ab7823ec849bae2e0679c31b106bd58e5e292c197ff35cc108160acda89
Brantley,ca5f2b3705998bdc02d660542ce3bb2a28bf59c1348ce6213eed8d09474b26d2,2433,188,2674,5,5300,Brantleyca5f2b3705998bdc02d660542ce3bb2a28bf59c1348ce6213eed8d09474b26d2
Camden,ca5f2b3705998bdc02d660542ce3bb2a28bf59c1348ce6213eed8d09474b26d2,6016,808,8209,16,15049,Camdenca5f2b3705998bdc02d660542ce3bb2a28bf59c1348ce6213eed8d09474b26d2
Charlton,ca5f2b3705998bdc02d660542ce3bb2a28bf59c1348ce6213eed8d09474b26d2,738,98,1241,2,2079,Charltonca5f2b3705998bdc02d660542ce3bb2a28bf59c1348ce6213eed8d09474b26d2
Glynn,ca5f2b3705998bdc02d660542ce3bb2a28bf59c1348ce6213eed8d09474b26d2,11493,1086,14453,41,27073,Glynnca5f2b3705998bdc02d660542ce3bb2a28bf59c1348ce6213eed8d09474b26d2
McIntosh,ca5f2b3705998bdc02d660542ce3bb2a28bf59c1348ce6213eed8d09474b26d2,1676,438,2250,7,4371,McIntoshca5f2b3705998bdc02d660542ce3bb2a28bf59c1348ce6213eed8d09474b26d2
Bulloch,667f2eecf018df6dfa72377d49d1830df2b0e482d945678f956bfaf401f41999,9998,823,10271,42,21134,Bulloch667f2eecf018df6dfa72377d49d1830df2b0e482d945678f956bfaf401f41999
Candler,667f2eecf018df6dfa72377d49d1830df2b0e482d945678f956bfaf401f41999,818,115,2234,3,3170,Candler667f2eecf018df6dfa72377d49d1830df2b0e482d945678f956bfaf401f41999
Effingham,667f2eecf018df6dfa72377d49d1830df2b0e482d945678f956bfaf401f41999,9533,541,10481,8,20563,Effingham667f2eecf018df6dfa72377d49d1830df2b0e482d945678f956bfaf401f41999
Emanuel,667f2eecf018df6dfa72377d49d1830df2b0e482d945678f956bfaf401f41999,1873,214,2051,6,4144,Emanuel667f2eecf018df6dfa72377d49d1830df2b0e482d945678f956bfaf401f41999
Evans,667f2eecf018df6dfa72377d49d1830df2b0e482d945678f956bfaf401f41999,949,149,1996,0,3094,Evans667f2eecf018df6dfa72377d49d1830df2b0e482d945678f956bfaf401f41999
Tattnall,667f2eecf018df6dfa72377d49d1830df2b0e482d945678f956bfaf401f41999,1029,112,1290,3,2434,Tattnall667f2eecf018df6dfa72377d49d1830df2b0e482d945678f956bfaf401f41999
Gwinnett,fee3ec94c903ce5c3e5bfdf93f3f05540036e356fc6ae166d00d269a40ab8105,18993,1302,15151,140,35586,Gwinnettfee3ec94c903ce5c3e5bfdf93f3f05540036e356fc6ae166d00d269a40ab8105
Cobb,290847bfca66eba70223381554e191f00b0f41d91260c5c97cffec6ba75958a7,8579,1522,5645,38,15784,Cobb290847bfca66eba70223381554e191f00b0f41d91260c5c97cffec6ba75958a7
Fulton,290847bfca66eba70223381554e191f00b0f41d91260c5c97cffec6ba75958a7,9301,1862,15349,42,26554,Fulton290847bfca66eba70223381554e191f00b0f41d91260c5c97cffec6ba75958a7
Cobb,2f0f4d5a7d92cb6112a3b0728bdeac0336f5520c78a86419b4d253959f1ee507,11427,1579,11166,84,24256,Cobb2f0f4d5a7d92cb6112a3b0728bdeac0336f5520c78a86419b4d253959f1ee507
Fulton,2f0f4d5a7d92cb6112a3b0728bdeac0336f5520c78a86419b4d253959f1ee507,4239,1188,9482,36,14945,Fulton2f0f4d5a7d92cb6112a3b0728bdeac0336f5520c78a86419b4d253959f1ee507
Atkinson,412d62988cd233e380a468f9cf3c88822ed65b2700daa1c200e4dceab9e48d2f,933,80,1014,1,2028,Atkinson412d62988cd233e380a468f9cf3c88822ed65b2700daa1c200e4dceab9e48d2f
Bacon,412d62988cd233e380a468f9cf3c88822ed65b2700daa1c200e4dceab9e48d2f,1159,130,1999,5,3293,Bacon412d62988cd233e380a468f9cf3c88822ed65b2700daa1c200e4dceab9e48d2f
Ben Hill,412d62988cd233e380a468f9cf3c88822ed65b2700daa1c200e4dceab9e48d2f,1253,170,3193,6,4622,Ben Hill412d62988cd233e380a468f9cf3c88822ed65b2700daa1c200e4dceab9e48d2f
Berrien,412d62988cd233e380a468f9cf3c88822ed65b2700daa1c200e4dceab9e48d2f,2588,312,2928,16,5844,Berrien412d62988cd233e380a468f9cf3c88822ed65b2700daa1c200e4dceab9e48d2f
Charlton,412d62988cd233e380a468f9cf3c88822ed65b2700daa1c200e4dceab9e48d2f,565,64,405,0,1034,Charlton412d62988cd233e380a468f9cf3c88822ed65b2700daa1c200e4dceab9e48d2f
Coffee,412d62988cd233e380a468f9cf3c88822ed65b2700daa1c200e4dceab9e48d2f,3684,354,6954,0,10992,Coffee412d62988cd233e380a468f9cf3c88822ed65b2700daa1c200e4dceab9e48d2f
Irwin,412d62988cd233e380a468f9cf3c88822ed65b2700daa1c200e4dceab9e48d2f,1466,102,1513,5,3086,Irwin412d62988cd233e380a468f9cf3c88822ed65b2700daa1c200e4dceab9e48d2f
Pierce,412d62988cd233e380a468f9cf3c88822ed65b2700daa1c200e4dceab9e48d2f,1824,299,4344,1,6468,Pierce412d62988cd233e380a468f9cf3c88822ed65b2700daa1c200e4dceab9e48d2f
Ware,412d62988cd233e380a468f9cf3c88822ed65b2700daa1c200e4dceab9e48d2f,4135,467,5453,5,10060,Ware412d62988cd233e380a468f9cf3c88822ed65b2700daa1c200e4dceab9e48d2f
Wilcox,412d62988cd233e380a468f9cf3c88822ed65b2700daa1c200e4dceab9e48d2f,384,97,573,0,1054,Wilcox412d62988cd233e380a468f9cf3c88822ed65b2700daa1c200e4dceab9e48d2f
Brooks,0ef470bbade1f8753d6e203535408132dfb6333f78601c21c1dcacf12d3cbbe9,1804,165,1815,25,3809,Brooks0ef470bbade1f8753d6e203535408132dfb6333f78601c21c1dcacf12d3cbbe9
Clinch,0ef470bbade1f8753d6e203535408132dfb6333f78601c21c1dcacf12d3cbbe9,688,61,955,3,1707,Clinch0ef470bbade1f8753d6e203535408132dfb6333f78601c21c1dcacf12d3cbbe9
Cook,0ef470bbade1f8753d6e203535408132dfb6333f78601c21c1dcacf12d3cbbe9,1607,154,2403,0,4164,Cook0ef470bbade1f8753d6e203535408132dfb6333f78601c21c1dcacf12d3cbbe9
Echols,0ef470bbade1f8753d6e203535408132dfb6333f78601c21c1dcacf12d3cbbe9,378,39,543,0,960,Echols0ef470bbade1f8753d6e203535408132dfb6333f78601c21c1dcacf12d3cbbe9
Lanier,0ef470bbade1f8753d6e203535408132dfb6333f78601c21c1dcacf12d3cbbe9,793,50,1123,0,1966,Lanier0ef470bbade1f8753d6e203535408132dfb6333f78601c21c1dcacf12d3cbbe9
Lowndes,0ef470bbade1f8753d6e203535408132dfb6333f78601c21c1dcacf12d3cbbe9,6892,859,14433,208,22392,Lowndes0ef470bbade1f8753d6e203535408132dfb6333f78601c21c1dcacf12d3cbbe9
Thomas,0ef470bbade1f8753d6e203535408132dfb6333f78601c21c1dcacf12d3cbbe9,1049,77,1113,0,2239,Thomas0ef470bbade1f8753d6e203535408132dfb6333f78601c21c1dcacf12d3cbbe9
Brooks,85326a93a6b78336855e7b009b3e5080242f394e86dcf3476b4d1ef42a8111ed,914,426,872,23,2235,Brooks85326a93a6b78336855e7b009b3e5080242f394e86dcf3476b4d1ef42a8111ed
Clinch,85326a93a6b78336855e7b009b3e5080242f394e86dcf3476b4d1ef42a8111ed,239,20,274,0,533,Clinch85326a93a6b78336855e7b009b3e5080242f394e86dcf3476b4d1ef42a8111ed
Cook,85326a93a6b78336855e7b009b3e5080242f394e86dcf3476b4d1ef42a8111ed,830,66,756,0,1652,Cook85326a93a6b78336855e7b009b3e5080242f394e86dcf3476b4d1ef42a8111ed
Echols,85326a93a6b78336855e7b009b3e5080242f394e86dcf3476b4d1ef42a8111ed,72,2,96,0,170,Echols85326a93a6b78336855e7b009b3e5080242f394e86dcf3476b4d1ef42a8111ed
Lanier,85326a93a6b78336855e7b009b3e5080242f394e86dcf3476b4d1ef42a8111ed,299,22,412,1,734,Lanier85326a93a6b78336855e7b009b3e5080242f394e86dcf3476b4d1ef42a8111ed
Lowndes,85326a93a6b78336855e7b009b3e5080242f394e86dcf3476b4d1ef42a8111ed,4296,635,9219,294,14444,Lowndes85326a93a6b78336855e7b009b3e5080242f394e86dcf3476b4d1ef42a8111ed
Thomas,85326a93a6b78336855e7b009b3e5080242f394e86dcf3476b4d1ef42a8111ed,422,53,418,0,893,Thomas85326a93a6b78336855e7b009b3e5080242f394e86dcf3476b4d1ef42a8111ed
Gwinnett,f17376585144fa3c04fde01b1995650ea68ecaf2a0a2a59c919b139d146aee43,30958,4092,29960,84,65094,Gwinnettf17376585144fa3c04fde01b1995650ea68ecaf2a0a2a59c919b139d146aee43
DeKalb,31084b492b24bb0e272fb7b82f360e5b2b1dba2915cd68a2ca8288961d4830bb,12472,1299,24640,37,38448,DeKalb31084b492b24bb0e272fb7b82f360e5b2b1dba2915cd68a2ca8288961d4830bb
Henry,31084b492b24bb0e272fb7b82f360e5b2b1dba2915cd68a2ca8288961d4830bb,8397,1017,22843,59,32316,Henry31084b492b24bb0e272fb7b82f360e5b2b1dba2915cd68a2ca8288961d4830bb
Colquitt,d9eb2f407771ae2de54ef04a976885d479f5c748d16fb5ad07adedd1a9c5acc8,5630,361,5057,6,11054,Colquittd9eb2f407771ae2de54ef04a976885d479f5c748d16fb5ad07adedd1a9c5acc8
Decatur,d9eb2f407771ae2de54ef04a976885d479f5c748d16fb5ad07adedd1a9c5acc8,3125,387,4409,20,7941,Decaturd9eb2f407771ae2de54ef04a976885d479f5c748d16fb5ad07adedd1a9c5acc8
Early,d9eb2f407771ae2de54ef04a976885d479f5c748d16fb5ad07adedd1a9c5acc8,1554,211,1613,0,3378,Earlyd9eb2f407771ae2de54ef04a976885d479f5c748d16fb5ad07adedd1a9c5acc8
Grady,d9eb2f407771ae2de54ef04a976885d479f5c748d16fb5ad07adedd1a9c5acc8,3132,226,3813,7,7178,Gradyd9eb2f407771ae2de54ef04a976885d479f5c748d16fb5ad07adedd1a9c5acc8
Miller,d9eb2f407771ae2de54ef04a976885d479f5c748d16fb5ad07adedd1a9c5acc8,900,114,1016,3,2033,Millerd9eb2f407771ae2de54ef04a976885d479f5c748d16fb5ad07adedd1a9c5acc8
Mitchell,d9eb2f407771ae2de54ef04a976885d479f5c748d16fb5ad07adedd1a9c5acc8,1774,144,1162,2,3082,Mitchelld9eb2f407771ae2de54ef04a976885d479f5c748d16fb5ad07adedd1a9c5acc8
Seminole,d9eb2f407771ae2de54ef04a976885d479f5c748d16fb5ad07adedd1a9c5acc8,1582,132,1111,4,2829,Seminoled9eb2f407771ae2de54ef04a976885d479f5c748d16fb5ad07adedd1a9c5acc8
Thomas,d9eb2f407771ae2de54ef04a976885d479f5c748d16fb5ad07adedd1a9c5acc8,4309,523,6736,5,11573,Thomasd9eb2f407771ae2de54ef04a976885d479f5c748d16fb5ad07adedd1a9c5acc8
Baker,c06906504b86667c2cf4e04375de260c3ab382b3181c2a34987c193f74c3e92d,492,94,381,1,968,Bakerc06906504b86667c2cf4e04375de260c3ab382b3181c2a34987c193f74c3e92d
Calhoun,c06906504b86667c2cf4e04375de260c3ab382b3181c2a34987c193f74c3e92d,955,125,500,1,1581,Calhounc06906504b86667c2cf4e04375de260c3ab382b3181c2a34987c193f74c3e92d
Clay,c06906504b86667c2cf4e04375de260c3ab382b3181c2a34987c193f74c3e92d,426,73,449,2,950,Clayc06906504b86667c2cf4e04375de260c3ab382b3181c2a34987c193f74c3e92d
Dougherty,c06906504b86667c2cf4e04375de260c3ab382b3181c2a34987c193f74c3e92d,15055,1282,12116,82,28535,Doughertyc06906504b86667c2cf4e04375de260c3ab382b3181c2a34987c193f74c3e92d
Mitchell,c06906504b86667c2cf4e04375de260c3ab382b3181c2a34987c193f74c3e92d,1169,264,1820,2,3255,Mitchellc06906504b86667c2cf4e04375de260c3ab382b3181c2a34987c193f74c3e92d
Quitman,c06906504b86667c2cf4e04375de260c3ab382b3181c2a34987c193f74c3e92d,333,29,291,0,653,Quitmanc06906504b86667c2cf4e04375de260c3ab382b3181c2a34987c193f74c3e92d
Randolph,c06906504b86667c2cf4e04375de260c3ab382b3181c2a34987c193f74c3e92d,1092,165,954,1,2212,Randolphc06906504b86667c2cf4e04375de260c3ab382b3181c2a34987c193f74c3e92d
Stewart,c06906504b86667c2cf4e04375de260c3ab382b3181c2a34987c193f74c3e92d,612,207,426,3,1248,Stewartc06906504b86667c2cf4e04375de260c3ab382b3181c2a34987c193f74c3e92d
Sumter,c06906504b86667c2cf4e04375de260c3ab382b3181c2a34987c193f74c3e92d,2199,439,2941,0,5579,Sumterc06906504b86667c2cf4e04375de260c3ab382b3181c2a34987c193f74c3e92d
Terrell,c06906504b86667c2cf4e04375de260c3ab382b3181c2a34987c193f74c3e92d,1501,207,1438,2,3148,Terrellc06906504b86667c2cf4e04375de260c3ab382b3181c2a34987c193f74c3e92d
Webster,c06906504b86667c2cf4e04375de260c3ab382b3181c2a34987c193f74c3e92d,346,84,303,1,734,Websterc06906504b86667c2cf4e04375de260c3ab382b3181c2a34987c193f74c3e92d
Crisp,0379c512db899e1a0fd89134f375591aafa0e2db47edc2b9345351544ceee447,1425,220,3089,9,4743,Crisp0379c512db899e1a0fd89134f375591aafa0e2db47edc2b9345351544ceee447
Dodge,0379c512db899e1a0fd89134f375591aafa0e2db47edc2b9345351544ceee447,2552,238,1974,0,4764,Dodge0379c512db899e1a0fd89134f375591aafa0e2db47edc2b9345351544ceee447
Dooly,0379c512db899e1a0fd89134f375591aafa0e2db47edc2b9345351544ceee447,835,76,1055,6,1972,Dooly0379c512db899e1a0fd89134f375591aafa0e2db47edc2b9345351544ceee447
Lee,0379c512db899e1a0fd89134f375591aafa0e2db47edc2b9345351544ceee447,5124,337,5471,4,10936,Lee0379c512db899e1a0fd89134f375591aafa0e2db47edc2b9345351544ceee447
Sumter,0379c512db899e1a0fd89134f375591aafa0e2db47edc2b9345351544ceee447,1039,95,1054,0,2188,Sumter0379c512db899e1a0fd89134f375591aafa0e2db47edc2b9345351544ceee447
Tift,0379c512db899e1a0fd89134f375591aafa0e2db47edc2b9345351544ceee447,3715,368,5645,8,9736,Tift0379c512db899e1a0fd89134f375591aafa0e2db47edc2b9345351544ceee447
Turner,0379c512db899e1a0fd89134f375591aafa0e2db47edc2b9345351544ceee447,632,54,1390,1,2077,Turner0379c512db899e1a0fd89134f375591aafa0e2db47edc2b9345351544ceee447
Wilcox,0379c512db899e1a0fd89134f375591aafa0e2db47edc2b9345351544ceee447,623,82,376,0,1081,Wilcox0379c512db899e1a0fd89134f375591aafa0e2db47edc2b9345351544ceee447
Worth,0379c512db899e1a0fd89134f375591aafa0e2db47edc2b9345351544ceee447,3368,181,2481,7,6037,Worth0379c512db899e1a0fd89134f375591aafa0e2db47edc2b9345351544ceee447
Crisp,0291233f1022417383da20a6bdb19fd709b4e62f601d8a14abc1acb0234aa866,848,100,1395,1,2344,Crisp0291233f1022417383da20a6bdb19fd709b4e62f601d8a14abc1acb0234aa866
Dodge,0291233f1022417383da20a6bdb19fd709b4e62f601d8a14abc1acb0234aa866,806,86,694,0,1586,Dodge0291233f1022417383da20a6bdb19fd709b4e62f601d8a14abc1acb0234aa866
Dooly,0291233f1022417383da20a6bdb19fd709b4e62f601d8a14abc1acb0234aa866,835,89,601,11,1536,Dooly0291233f1022417383da20a6bdb19fd709b4e62f601d8a14abc1acb0234aa866
Lee,0291233f1022417383da20a6bdb19fd709b4e62f601d8a14abc1acb0234aa866,1298,145,1400,1,2844,Lee0291233f1022417383da20a6bdb19fd709b4e62f601d8a14abc1acb0234aa866
Sumter,0291233f1022417383da20a6bdb19fd709b4e62f601d8a14abc1acb0234aa866,456,82,619,0,1157,Sumter0291233f1022417383da20a6bdb19fd709b4e62f601d8a14abc1acb0234aa866
Tift,0291233f1022417383da20a6bdb19fd709b4e62f601d8a14abc1acb0234aa866,1542,168,2099,7,3816,Tift0291233f1022417383da20a6bdb19fd709b4e62f601d8a14abc1acb0234aa866
Turner,0291233f1022417383da20a6bdb19fd709b4e62f601d8a14abc1acb0234aa866,496,27,601,2,1126,Turner0291233f1022417383da20a6bdb19fd709b4e62f601d8a14abc1acb0234aa866
Wilcox,0291233f1022417383da20a6bdb19fd709b4e62f601d8a14abc1acb0234aa866,392,25,123,0,540,Wilcox0291233f1022417383da20a6bdb19fd709b4e62f601d8a14abc1acb0234aa866
Worth,0291233f1022417383da20a6bdb19fd709b4e62f601d8a14abc1acb0234aa866,935,91,876,2,1904,Worth0291233f1022417383da20a6bdb19fd709b4e62f601d8a14abc1acb0234aa866
Bartow,3ddbc40e9257425391e2f75ce6e707926c335fbe247373186d25c8057238ffa4,10314,766,8558,9,19647,Bartow3ddbc40e9257425391e2f75ce6e707926c335fbe247373186d25c8057238ffa4
Cherokee,3ddbc40e9257425391e2f75ce6e707926c335fbe247373186d25c8057238ffa4,15356,1521,18860,11,35748,Cherokee3ddbc40e9257425391e2f75ce6e707926c335fbe247373186d25c8057238ffa4
Cobb,3ddbc40e9257425391e2f75ce6e707926c335fbe247373186d25c8057238ffa4,4369,528,2952,7,7856,Cobb3ddbc40e9257425391e2f75ce6e707926c335fbe247373186d25c8057238ffa4
Chattahoochee,fa00b02aa13834322d4b4ff33907d92143bce75a7546e0677a586a88cbcf2334,530,36,440,5,1011,Chattahoocheefa00b02aa13834322d4b4ff33907d92143bce75a7546e0677a586a88cbcf2334
Macon,fa00b02aa13834322d4b4ff33907d92143bce75a7546e0677a586a88cbcf2334,1396,193,1514,0,3103,Maconfa00b02aa13834322d4b4ff33907d92143bce75a7546e0677a586a88cbcf2334
Marion,fa00b02aa13834322d4b4ff33907d92143bce75a7546e0677a586a88cbcf2334,1130,213,918,0,2261,Marionfa00b02aa13834322d4b4ff33907d92143bce75a7546e0677a586a88cbcf2334
Muscogee,fa00b02aa13834322d4b4ff33907d92143bce75a7546e0677a586a88cbcf2334,13802,1687,16002,73,31564,Muscogeefa00b02aa13834322d4b4ff33907d92143bce75a7546e0677a586a88cbcf2334
Schley,fa00b02aa13834322d4b4ff33907d92143bce75a7546e0677a586a88cbcf2334,385,64,761,0,1210,Schleyfa00b02aa13834322d4b4ff33907d92143bce75a7546e0677a586a88cbcf2334
Talbot,fa00b02aa13834322d4b4ff33907d92143bce75a7546e0677a586a88cbcf2334,1384,452,612,0,2448,Talbotfa00b02aa13834322d4b4ff33907d92143bce75a7546e0677a586a88cbcf2334
Taylor,fa00b02aa13834322d4b4ff33907d92143bce75a7546e0677a586a88cbcf2334,1024,209,1246,0,2479,Taylorfa00b02aa13834322d4b4ff33907d92143bce75a7546e0677a586a88cbcf2334
Fayette,33fb8ef3a19a5622465048db37d7bbf0ae580babf0c1f63a341fa9f1de38df25,10831,1509,21443,6,33789,Fayette33fb8ef3a19a5622465048db37d7bbf0ae580babf0c1f63a341fa9f1de38df25
Lamar,33fb8ef3a19a5622465048db37d7bbf0ae580babf0c1f63a341fa9f1de38df25,2409,258,3351,10,6028,Lamar33fb8ef3a19a5622465048db37d7bbf0ae580babf0c1f63a341fa9f1de38df25
Pike,33fb8ef3a19a5622465048db37d7bbf0ae580babf0c1f63a341fa9f1de38df25,2840,313,4510,6,7669,Pike33fb8ef3a19a5622465048db37d7bbf0ae580babf0c1f63a341fa9f1de38df25
Spalding,33fb8ef3a19a5622465048db37d7bbf0ae580babf0c1f63a341fa9f1de38df25,7098,762,11026,11,18897,Spalding33fb8ef3a19a5622465048db37d7bbf0ae580babf0c1f63a341fa9f1de38df25
Henry,a47bc2391e49eee4bbff923445d8552104ccfa2e322b033a179d341a64212663,8621,1163,22036,30,31850,Henrya47bc2391e49eee4bbff923445d8552104ccfa2e322b033a179d341a64212663
Newton,a47bc2391e49eee4bbff923445d8552104ccfa2e322b033a179d341a64212663,6332,506,4952,0,11790,Newtona47bc2391e49eee4bbff923445d8552104ccfa2e322b033a179d341a64212663
Rockdale,a47bc2391e49eee4bbff923445d8552104ccfa2e322b033a179d341a64212663,1485,181,3136,2,4804,Rockdalea47bc2391e49eee4bbff923445d8552104ccfa2e322b033a179d341a64212663
Henry,939d18e6e2363897d71315043949bb31eabd221143ae403b014516951da87b3a,6790,841,15245,35,22911,Henry939d18e6e2363897d71315043949bb31eabd221143ae403b014516951da87b3a
Newton,939d18e6e2363897d71315043949bb31eabd221143ae403b014516951da87b3a,2405,252,3046,0,5703,Newton939d18e6e2363897d71315043949bb31eabd221143ae403b014516951da87b3a
Rockdale,939d18e6e2363897d71315043949bb31eabd221143ae403b014516951da87b3a,1096,122,2938,2,4158,Rockdale939d18e6e2363897d71315043949bb31eabd221143ae403b014516951da87b3a
Bibb,6af80a9a11a276851df589b75bc3f70928f5298d4d52d7c4e999ab1b097f7a1e,11215,1176,8963,28,21382,Bibb6af80a9a11a276851df589b75bc3f70928f5298d4d52d7c4e999ab1b097f7a1e
Crawford,6af80a9a11a276851df589b75bc3f70928f5298d4d52d7c4e999ab1b097f7a1e,1861,205,2088,4,4158,Crawford6af80a9a11a276851df589b75bc3f70928f5298d4d52d7c4e999ab1b097f7a1e
Houston,6af80a9a11a276851df589b75bc3f70928f5298d4d52d7c4e999ab1b097f7a1e,2826,327,4870,8,8031,Houston6af80a9a11a276851df589b75bc3f70928f5298d4d52d7c4e999ab1b097f7a1e
Monroe,6af80a9a11a276851df589b75bc3f70928f5298d4d52d7c4e999ab1b097f7a1e,4874,377,5166,8,10425,Monroe6af80a9a11a276851df589b75bc3f70928f5298d4d52d7c4e999ab1b097f7a1e
Peach,6af80a9a11a276851df589b75bc3f70928f5298d4d52d7c4e999ab1b097f7a1e,2466,252,5186,19,7923,Peach6af80a9a11a276851df589b75bc3f70928f5298d4d52d7c4e999ab1b097f7a1e
Upson,6af80a9a11a276851df589b75bc3f70928f5298d4d52d7c4e999ab1b097f7a1e,2406,379,6043,4,8832,Upson6af80a9a11a276851df589b75bc3f70928f5298d4d52d7c4e999ab1b097f7a1e
Appling,516b7482b63431ade6be2de72d7e4c179f88d9b55a8143f6b1c430db405148bf,3054,404,2264,2,5724,Appling516b7482b63431ade6be2de72d7e4c179f88d9b55a8143f6b1c430db405148bf
Jeff Davis,516b7482b63431ade6be2de72d7e4c179f88d9b55a8143f6b1c430db405148bf,1778,162,2044,2,3986,Jeff Davis516b7482b63431ade6be2de72d7e4c179f88d9b55a8143f6b1c430db405148bf
Liberty,516b7482b63431ade6be2de72d7e4c179f88d9b55a8143f6b1c430db405148bf,1114,68,1293,4,2479,Liberty516b7482b63431ade6be2de72d7e4c179f88d9b55a8143f6b1c430db405148bf
Long,516b7482b63431ade6be2de72d7e4c179f88d9b55a8143f6b1c430db405148bf,1550,54,1466,6,3076,Long516b7482b63431ade6be2de72d7e4c179f88d9b55a8143f6b1c430db405148bf
Montgomery,516b7482b63431ade6be2de72d7e4c179f88d9b55a8143f6b1c430db405148bf,1688,92,1041,0,2821,Montgomery516b7482b63431ade6be2de72d7e4c179f88d9b55a8143f6b1c430db405148bf
Tattnall,516b7482b63431ade6be2de72d7e4c179f88d9b55a8143f6b1c430db405148bf,1208,319,1645,0,3172,Tattnall516b7482b63431ade6be2de72d7e4c179f88d9b55a8143f6b1c430db405148bf
Telfair,516b7482b63431ade6be2de72d7e4c179f88d9b55a8143f6b1c430db405148bf,1406,113,1023,1,2543,Telfair516b7482b63431ade6be2de72d7e4c179f88d9b55a8143f6b1c430db405148bf
Toombs,516b7482b63431ade6be2de72d7e4c179f88d9b55a8143f6b1c430db405148bf,2948,419,3974,1,7342,Toombs516b7482b63431ade6be2de72d7e4c179f88d9b55a8143f6b1c430db405148bf
Treutlen,516b7482b63431ade6be2de72d7e4c179f88d9b55a8143f6b1c430db405148bf,700,126,1148,2,1976,Treutlen516b7482b63431ade6be2de72d7e4c179f88d9b55a8143f6b1c430db405148bf
Wayne,516b7482b63431ade6be2de72d7e4c179f88d9b55a8143f6b1c430db405148bf,3682,318,4671,8,8679,Wayne516b7482b63431ade6be2de72d7e4c179f88d9b55a8143f6b1c430db405148bf
Wheeler,516b7482b63431ade6be2de72d7e4c179f88d9b55a8143f6b1c430db405148bf,735,100,693,3,1531,Wheeler516b7482b63431ade6be2de72d7e4c179f88d9b55a8143f6b1c430db405148bf
Bleckley,725ad318de24b75cc6f2aa6ecc642547880bd06c22a195eed2c6233f32adefc4,1752,165,2263,6,4186,Bleckley725ad318de24b75cc6f2aa6ecc642547880bd06c22a195eed2c6233f32adefc4
Houston,725ad318de24b75cc6f2aa6ecc642547880bd06c22a195eed2c6233f32adefc4,11615,1589,25113,52,38369,Houston725ad318de24b75cc6f2aa6ecc642547880bd06c22a195eed2c6233f32adefc4
Laurens,725ad318de24b75cc6f2aa6ecc642547880bd06c22a195eed2c6233f32adefc4,7929,878,6563,3,15373,Laurens725ad318de24b75cc6f2aa6ecc642547880bd06c22a195eed2c6233f32adefc4
Pulaski,725ad318de24b75cc6f2aa6ecc642547880bd06c22a195eed2c6233f32adefc4,680,147,2018,1,2846,Pulaski725ad318de24b75cc6f2aa6ecc642547880bd06c22a195eed2c6233f32adefc4
Cherokee,9ff7807248acfce296253c7b9009b303218d88d65d0e424e512e9eec28702f1b,22042,2431,31115,7,55595,Cherokee9ff7807248acfce296253c7b9009b303218d88d65d0e424e512e9eec28702f1b
Fulton,9ff7807248acfce296253c7b9009b303218d88d65d0e424e512e9eec28702f1b,6922,1209,14414,14,22559,Fulton9ff7807248acfce296253c7b9009b303218d88d65d0e424e512e9eec28702f1b
Richmond,a7bde10b0b75a805afa58e06b38dc3924c4c42ae39f0f5470471dbb2410de35f,24228,2968,25255,81,52532,Richmonda7bde10b0b75a805afa58e06b38dc3924c4c42ae39f0f5470471dbb2410de35f
Burke,22c5ea6410d7bf7639d5f3631f841e4661386b495c6207a7ec7b24ec9d01f7a9,3505,609,2774,0,6888,Burke22c5ea6410d7bf7639d5f3631f841e4661386b495c6207a7ec7b24ec9d01f7a9
Columbia,22c5ea6410d7bf7639d5f3631f841e4661386b495c6207a7ec7b24ec9d01f7a9,5754,514,4969,5,11242,Columbia22c5ea6410d7bf7639d5f3631f841e4661386b495c6207a7ec7b24ec9d01f7a9
Emanuel,22c5ea6410d7bf7639d5f3631f841e4661386b495c6207a7ec7b24ec9d01f7a9,1374,46,628,1,2049,Emanuel22c5ea6410d7bf7639d5f3631f841e4661386b495c6207a7ec7b24ec9d01f7a9
Glascock,22c5ea6410d7bf7639d5f3631f841e4661386b495c6207a7ec7b24ec9d01f7a9,506,52,573,0,1131,Glascock22c5ea6410d7bf7639d5f3631f841e4661386b495c6207a7ec7b24ec9d01f7a9
Jefferson,22c5ea6410d7bf7639d5f3631f841e4661386b495c6207a7ec7b24ec9d01f7a9,2209,253,1818,11,4291,Jefferson22c5ea6410d7bf7639d5f3631f841e4661386b495c6207a7ec7b24ec9d01f7a9
Jenkins,22c5ea6410d7bf7639d5f3631f841e4661386b495c6207a7ec7b24ec9d01f7a9,943,131,1231,7,2312,Jenkins22c5ea6410d7bf7639d5f3631f841e4661386b495c6207a7ec7b24ec9d01f7a9
Johnson,22c5ea6410d7bf7639d5f3631f841e4661386b495c6207a7ec7b24ec9d01f7a9,1077,160,1485,0,2722,Johnson22c5ea6410d7bf7639d5f3631f841e4661386b495c6207a7ec7b24ec9d01f7a9
McDuffie,22c5ea6410d7bf7639d5f3631f841e4661386b495c6207a7ec7b24ec9d01f7a9,2627,394,3989,0,7010,McDuffie22c5ea6410d7bf7639d5f3631f841e4661386b495c6207a7ec7b24ec9d01f7a9
Richmond,22c5ea6410d7bf7639d5f3631f841e4661386b495c6207a7ec7b24ec9d01f7a9,4670,536,4331,7,9544,Richmond22c5ea6410d7bf7639d5f3631f841e4661386b495c6207a7ec7b24ec9d01f7a9
Screven,22c5ea6410d7bf7639d5f3631f841e4661386b495c6207a7ec7b24ec9d01f7a9,1989,120,2063,0,4172,Screven22c5ea6410d7bf7639d5f3631f841e4661386b495c6207a7ec7b24ec9d01f7a9
Warren,22c5ea6410d7bf7639d5f3631f841e4661386b495c6207a7ec7b24ec9d01f7a9,583,92,794,1,1470,Warren22c5ea6410d7bf7639d5f3631f841e4661386b495c6207a7ec7b24ec9d01f7a9
Columbia,2b4cc4d62328437f541f7633a5580357390c209d9a21ea0105648bd5b35d6a34,13677,1558,20465,12,35712,Columbia2b4cc4d62328437f541f7633a5580357390c209d9a21ea0105648bd5b35d6a34
Elbert,2b4cc4d62328437f541f7633a5580357390c209d9a21ea0105648bd5b35d6a34,1847,268,2850,22,4987,Elbert2b4cc4d62328437f541f7633a5580357390c209d9a21ea0105648bd5b35d6a34
Hart,2b4cc4d62328437f541f7633a5580357390c209d9a21ea0105648bd5b35d6a34,2607,256,3249,0,6112,Hart2b4cc4d62328437f541f7633a5580357390c209d9a21ea0105648bd5b35d6a34
Lincoln,2b4cc4d62328437f541f7633a5580357390c209d9a21ea0105648bd5b35d6a34,1048,140,1449,0,2637,Lincoln2b4cc4d62328437f541f7633a5580357390c209d9a21ea0105648bd5b35d6a34
Oglethorpe,2b4cc4d62328437f541f7633a5580357390c209d9a21ea0105648bd5b35d6a34,1525,278,2717,1,4521,Oglethorpe2b4cc4d62328437f541f7633a5580357390c209d9a21ea0105648bd5b35d6a34
Richmond,2b4cc4d62328437f541f7633a5580357390c209d9a21ea0105648bd5b35d6a34,78,12,87,0,177,Richmond2b4cc4d62328437f541f7633a5580357390c209d9a21ea0105648bd5b35d6a34
Taliaferro,2b4cc4d62328437f541f7633a5580357390c209d9a21ea0105648bd5b35d6a34,146,16,151,0,313,Taliaferro2b4cc4d62328437f541f7633a5580357390c209d9a21ea0105648bd5b35d6a34
Wilkes,2b4cc4d62328437f541f7633a5580357390c209d9a21ea0105648bd5b35d6a34,1104,85,1232,3,2424,Wilkes2b4cc4d62328437f541f7633a5580357390c209d9a21ea0105648bd5b35d6a34
Columbia,8f076b975a8538b6c348e8f6db66f56390ce4d5a21b9dfd76c031ae941937615,5094,909,8132,7,14142,Columbia8f076b975a8538b6c348e8f6db66f56390ce4d5a21b9dfd76c031ae941937615
Elbert,8f076b975a8538b6c348e8f6db66f56390ce4d5a21b9dfd76c031ae941937615,957,203,1450,36,2646,Elbert8f076b975a8538b6c348e8f6db66f56390ce4d5a21b9dfd76c031ae941937615
Hart,8f076b975a8538b6c348e8f6db66f56390ce4d5a21b9dfd76c031ae941937615,1419,217,1930,0,3566,Hart8f076b975a8538b6c348e8f6db66f56390ce4d5a21b9dfd76c031ae941937615
Lincoln,8f076b975a8538b6c348e8f6db66f56390ce4d5a21b9dfd76c031ae941937615,483,237,598,1,1319,Lincoln8f076b975a8538b6c348e8f6db66f56390ce4d5a21b9dfd76c031ae941937615
Oglethorpe,8f076b975a8538b6c348e8f6db66f56390ce4d5a21b9dfd76c031ae941937615,728,86,1067,1,1882,Oglethorpe8f076b975a8538b6c348e8f6db66f56390ce4d5a21b9dfd76c031ae941937615
Richmond,8f076b975a8538b6c348e8f6db66f56390ce4d5a21b9dfd76c031ae941937615,58,7,95,0,160,Richmond8f076b975a8538b6c348e8f6db66f56390ce4d5a21b9dfd76c031ae941937615
Taliaferro,8f076b975a8538b6c348e8f6db66f56390ce4d5a21b9dfd76c031ae941937615,203,79,209,1,492,Taliaferro8f076b975a8538b6c348e8f6db66f56390ce4d5a21b9dfd76c031ae941937615
Wilkes,8f076b975a8538b6c348e8f6db66f56390ce4d5a21b9dfd76c031ae941937615,930,90,759,2,1781,Wilkes8f076b975a8538b6c348e8f6db66f56390ce4d5a21b9dfd76c031ae941937615
Baldwin,f056e61990b7a0414d8a0ae19c648127dc20eef1066d9c456f258ac99052171c,4382,529,6017,6,10934,Baldwinf056e61990b7a0414d8a0ae19c648127dc20eef1066d9c456f258ac99052171c
Bibb,f056e61990b7a0414d8a0ae19c648127dc20eef1066d9c456f258ac99052171c,2173,209,1605,5,3992,Bibbf056e61990b7a0414d8a0ae19c648127dc20eef1066d9c456f258ac99052171c
Butts,f056e61990b7a0414d8a0ae19c648127dc20eef1066d9c456f258ac99052171c,2190,227,5494,0,7911,Buttsf056e61990b7a0414d8a0ae19c648127dc20eef1066d9c456f258ac99052171c
Greene,f056e61990b7a0414d8a0ae19c648127dc20eef1066d9c456f258ac99052171c,2018,402,4629,7,7056,Greenef056e61990b7a0414d8a0ae19c648127dc20eef1066d9c456f258ac99052171c
Jasper,f056e61990b7a0414d8a0ae19c648127dc20eef1066d9c456f258ac99052171c,1972,263,2762,7,5004,Jasperf056e61990b7a0414d8a0ae19c648127dc20eef1066d9c456f258ac99052171c
Jones,f056e61990b7a0414d8a0ae19c648127dc20eef1066d9c456f258ac99052171c,1785,213,2371,1,4370,Jonesf056e61990b7a0414d8a0ae19c648127dc20eef1066d9c456f258ac99052171c
Morgan,f056e61990b7a0414d8a0ae19c648127dc20eef1066d9c456f258ac99052171c,2994,299,4560,4,7857,Morganf056e61990b7a0414d8a0ae19c648127dc20eef1066d9c456f258ac99052171c
Putnam,f056e61990b7a0414d8a0ae19c648127dc20eef1066d9c456f258ac99052171c,2837,454,4327,4,7622,Putnamf056e61990b7a0414d8a0ae19c648127dc20eef1066d9c456f258ac99052171c
Walton,f056e61990b7a0414d8a0ae19c648127dc20eef1066d9c456f258ac99052171c,3156,176,1949,9,5290,Waltonf056e61990b7a0414d8a0ae19c648127dc20eef1066d9c456f258ac99052171c
Bibb,512e541499354e913e0b71b8435507600d0c2a4a44be1ebabf953bcfc2b97629,11841,1619,12571,97,26128,Bibb512e541499354e913e0b71b8435507600d0c2a4a44be1ebabf953bcfc2b97629
Hancock,512e541499354e913e0b71b8435507600d0c2a4a44be1ebabf953bcfc2b97629,1347,259,1019,7,2632,Hancock512e541499354e913e0b71b8435507600d0c2a4a44be1ebabf953bcfc2b97629
Houston,512e541499354e913e0b71b8435507600d0c2a4a44be1ebabf953bcfc2b97629,1028,144,1283,3,2458,Houston512e541499354e913e0b71b8435507600d0c2a4a44be1ebabf953bcfc2b97629
Jones,512e541499354e913e0b71b8435507600d0c2a4a44be1ebabf953bcfc2b97629,1799,301,2773,0,4873,Jones512e541499354e913e0b71b8435507600d0c2a4a44be1ebabf953bcfc2b97629
Twiggs,512e541499354e913e0b71b8435507600d0c2a4a44be1ebabf953bcfc2b97629,1513,237,1100,0,2850,Twiggs512e541499354e913e0b71b8435507600d0c2a4a44be1ebabf953bcfc2b97629
Washington,512e541499354e913e0b71b8435507600d0c2a4a44be1ebabf953bcfc2b97629,2683,555,2850,18,6106,Washington512e541499354e913e0b71b8435507600d0c2a4a44be1ebabf953bcfc2b97629
Wilkinson,512e541499354e913e0b71b8435507600d0c2a4a44be1ebabf953bcfc2b97629,1627,139,996,3,2765,Wilkinson512e541499354e913e0b71b8435507600d0c2a4a44be1ebabf953bcfc2b97629
Forsyth,1df168fc9acc1cbe76f563aa1b630dc1d253f54ac180183d7cf464257ba96c16,18908,2756,51726,27,73417,Forsyth1df168fc9acc1cbe76f563aa1b630dc1d253f54ac180183d7cf464257ba96c16
Forsyth,b3847af4be65e0687980c8da437b051f00caa66e43ce05e585d6bc897304de8f,5558,1069,13515,11,20153,Forsythb3847af4be65e0687980c8da437b051f00caa66e43ce05e585d6bc897304de8f
Carroll,7ab47082a9e16b1f12a9f10dfd7acad71818e3a1da92ff13e4c881d16b57928e,2706,157,2252,2,5117,Carroll7ab47082a9e16b1f12a9f10dfd7acad71818e3a1da92ff13e4c881d16b57928e
Coweta,7ab47082a9e16b1f12a9f10dfd7acad71818e3a1da92ff13e4c881d16b57928e,23239,2303,25735,17,51294,Coweta7ab47082a9e16b1f12a9f10dfd7acad71818e3a1da92ff13e4c881d16b57928e
Fulton,7ab47082a9e16b1f12a9f10dfd7acad71818e3a1da92ff13e4c881d16b57928e,489,19,488,1,997,Fulton7ab47082a9e16b1f12a9f10dfd7acad71818e3a1da92ff13e4c881d16b57928e
Heard,7ab47082a9e16b1f12a9f10dfd7acad71818e3a1da92ff13e4c881d16b57928e,1966,211,1392,2,3571,Heard7ab47082a9e16b1f12a9f10dfd7acad71818e3a1da92ff13e4c881d16b57928e
Troup,7ab47082a9e16b1f12a9f10dfd7acad71818e3a1da92ff13e4c881d16b57928e,3265,252,3547,57,7121,Troup7ab47082a9e16b1f12a9f10dfd7acad71818e3a1da92ff13e4c881d16b57928e
Harris,ec7f0fa3c6a90c1de28b77c74e81e8da0e4a28d1d110364a5e15a17b0f169503,5050,469,6377,1,11897,Harrisec7f0fa3c6a90c1de28b77c74e81e8da0e4a28d1d110364a5e15a17b0f169503
Meriwether,ec7f0fa3c6a90c1de28b77c74e81e8da0e4a28d1d110364a5e15a17b0f169503,2910,210,2024,2,5146,Meriwetherec7f0fa3c6a90c1de28b77c74e81e8da0e4a28d1d110364a5e15a17b0f169503
Muscogee,ec7f0fa3c6a90c1de28b77c74e81e8da0e4a28d1d110364a5e15a17b0f169503,10146,1173,9171,10,20500,Muscogeeec7f0fa3c6a90c1de28b77c74e81e8da0e4a28d1d110364a5e15a17b0f169503
Troup,ec7f0fa3c6a90c1de28b77c74e81e8da0e4a28d1d110364a5e15a17b0f169503,4114,517,5020,64,9715,Troupec7f0fa3c6a90c1de28b77c74e81e8da0e4a28d1d110364a5e15a17b0f169503
Harris,aff85d8aec446efc413bd686f913fcad08c99025a7b0cfa8c60b43bee77dfa55,1696,217,2085,0,3998,Harrisaff85d8aec446efc413bd686f913fcad08c99025a7b0cfa8c60b43bee77dfa55
Meriwether,aff85d8aec446efc413bd686f913fcad08c99025a7b0cfa8c60b43bee77dfa55,2145,188,1237,3,3573,Meriwetheraff85d8aec446efc413bd686f913fcad08c99025a7b0cfa8c60b43bee77dfa55
Muscogee,aff85d8aec446efc413bd686f913fcad08c99025a7b0cfa8c60b43bee77dfa55,4869,651,6228,8,11756,Muscogeeaff85d8aec446efc413bd686f913fcad08c99025a7b0cfa8c60b43bee77dfa55
Troup,aff85d8aec446efc413bd686f913fcad08c99025a7b0cfa8c60b43bee77dfa55,3454,391,3020,90,6955,Troupaff85d8aec446efc413bd686f913fcad08c99025a7b0cfa8c60b43bee77dfa55
Carroll,35f6cbab7f2e2faf86780a1ae75da0cf38df9fc6e91fee4351f549afa9c2e6c6,13259,1021,17279,62,31621,Carroll35f6cbab7f2e2faf86780a1ae75da0cf38df9fc6e91fee4351f549afa9c2e6c6
Douglas,35f6cbab7f2e2faf86780a1ae75da0cf38df9fc6e91fee4351f549afa9c2e6c6,4539,556,8349,4,13448,Douglas35f6cbab7f2e2faf86780a1ae75da0cf38df9fc6e91fee4351f549afa9c2e6c6
Paulding,35f6cbab7f2e2faf86780a1ae75da0cf38df9fc6e91fee4351f549afa9c2e6c6,4089,575,8838,3,13505,Paulding35f6cbab7f2e2faf86780a1ae75da0cf38df9fc6e91fee4351f549afa9c2e6c6
Haralson,a1c015ab8740315d7636a0624d9c5503aa864f35105c6c94ef0fdd5dd5ec9bb3,4826,348,4365,6,9545,Haralsona1c015ab8740315d7636a0624d9c5503aa864f35105c6c94ef0fdd5dd5ec9bb3
Paulding,a1c015ab8740315d7636a0624d9c5503aa864f35105c6c94ef0fdd5dd5ec9bb3,11241,1845,25672,15,38773,Pauldinga1c015ab8740315d7636a0624d9c5503aa864f35105c6c94ef0fdd5dd5ec9bb3
Polk,a1c015ab8740315d7636a0624d9c5503aa864f35105c6c94ef0fdd5dd5ec9bb3,3846,384,7713,7,11950,Polka1c015ab8740315d7636a0624d9c5503aa864f35105c6c94ef0fdd5dd5ec9bb3
Cobb,114c19471e010e18ad813a6cb3cbb7dfe8895aa48621ef67d9be437523a1b3ef,40795,5860,22874,82,69611,Cobb114c19471e010e18ad813a6cb3cbb7dfe8895aa48621ef67d9be437523a1b3ef
Fulton,114c19471e010e18ad813a6cb3cbb7dfe8895aa48621ef67d9be437523a1b3ef,2871,470,5156,9,8506,Fulton114c19471e010e18ad813a6cb3cbb7dfe8895aa48621ef67d9be437523a1b3ef
Cobb,e9172b21cfb12aba9dd095fbdfe1fdc76744b2470756eeb26c1b5784c1aed4a4,24696,2854,25256,96,52902,Cobbe9172b21cfb12aba9dd095fbdfe1fdc76744b2470756eeb26c1b5784c1aed4a4
Clayton,6850f69bbe89096fad49d0835d88f8d4e48720b7054f60dcff90f88e89f1d596,16370,1147,22229,58,39804,Clayton6850f69bbe89096fad49d0835d88f8d4e48720b7054f60dcff90f88e89f1d596
Fayette,6850f69bbe89096fad49d0835d88f8d4e48720b7054f60dcff90f88e89f1d596,4088,588,8942,12,13630,Fayette6850f69bbe89096fad49d0835d88f8d4e48720b7054f60dcff90f88e89f1d596
Douglas,e659cc58c4796e5de29474e1072ce226667a6da21ad11a07d66ad93c47f12c37,11152,1186,19855,25,32218,Douglase659cc58c4796e5de29474e1072ce226667a6da21ad11a07d66ad93c47f12c37
Fulton,e659cc58c4796e5de29474e1072ce226667a6da21ad11a07d66ad93c47f12c37,8561,862,24409,49,33881,Fultone659cc58c4796e5de29474e1072ce226667a6da21ad11a07d66ad93c47f12c37
Fulton,624c9d88da36a1a45e814440aed510fc27de6667bfe012c9d067a2ba2af7936e,32864,2288,31286,260,66698,Fulton624c9d88da36a1a45e814440aed510fc27de6667bfe012c9d067a2ba2af7936e
Cobb,f2aec564723321df850ac8367b32187181f99c61102ebf370301e778d18809e5,36173,4419,29924,72,70588,Cobbf2aec564723321df850ac8367b32187181f99c61102ebf370301e778d18809e5
Cobb,001109651dac646ee35bbb8e46760c8fd41863e6a8b5221911e06523d329346e,4871,824,4277,15,9987,Cobb001109651dac646ee35bbb8e46760c8fd41863e6a8b5221911e06523d329346e
Fulton,001109651dac646ee35bbb8e46760c8fd41863e6a8b5221911e06523d329346e,2891,263,3117,7,6278,Fulton001109651dac646ee35bbb8e46760c8fd41863e6a8b5221911e06523d329346e
Cobb,abecdfc6c5432645c4686515921e48bf25857612da80a5e9c99a1cd45dd9e122,7975,959,10846,30,19810,Cobbabecdfc6c5432645c4686515921e48bf25857612da80a5e9c99a1cd45dd9e122
Fulton,abecdfc6c5432645c4686515921e48bf25857612da80a5e9c99a1cd45dd9e122,12552,1792,25312,76,39732,Fultonabecdfc6c5432645c4686515921e48bf25857612da80a5e9c99a1cd45dd9e122
Fulton,9dd4190e9efbaf30cca22f5ca0b1df40619e5fd4802f96a840d9ea9f2778bddd,26711,2472,37671,187,67041,Fulton9dd4190e9efbaf30cca22f5ca0b1df40619e5fd4802f96a840d9ea9f2778bddd
DeKalb,4feb9398a89b957e69b4d963f8b320e68feb8ea3698ca0df6750d5f2fe123727,13759,2287,15682,19,31747,DeKalb4feb9398a89b957e69b4d963f8b320e68feb8ea3698ca0df6750d5f2fe123727
Fulton,4feb9398a89b957e69b4d963f8b320e68feb8ea3698ca0df6750d5f2fe123727,1386,295,2193,0,3874,Fulton4feb9398a89b957e69b4d963f8b320e68feb8ea3698ca0df6750d5f2fe123727
Gwinnett,4feb9398a89b957e69b4d963f8b320e68feb8ea3698ca0df6750d5f2fe123727,4274,656,1488,11,6429,Gwinnett4feb9398a89b957e69b4d963f8b320e68feb8ea3698ca0df6750d5f2fe123727
DeKalb,d568aa66c05bc07a59421b18653cfe1a9b1dc8fb3e672202fbecc068c56065eb,9562,1431,14817,32,25842,DeKalbd568aa66c05bc07a59421b18653cfe1a9b1dc8fb3e672202fbecc068c56065eb
Fulton,d568aa66c05bc07a59421b18653cfe1a9b1dc8fb3e672202fbecc068c56065eb,494,135,1128,3,1760,Fultond568aa66c05bc07a59421b18653cfe1a9b1dc8fb3e672202fbecc068c56065eb
Gwinnett,d568aa66c05bc07a59421b18653cfe1a9b1dc8fb3e672202fbecc068c56065eb,3079,292,1792,20,5183,Gwinnettd568aa66c05bc07a59421b18653cfe1a9b1dc8fb3e672202fbecc068c56065eb
DeKalb,080d771436aaf096f46596fc022609ee66f721f5bfcb7a68c0ff9005594dfe7f,16148,1697,23815,68,41728,DeKalb080d771436aaf096f46596fc022609ee66f721f5bfcb7a68c0ff9005594dfe7f
Gwinnett,080d771436aaf096f46596fc022609ee66f721f5bfcb7a68c0ff9005594dfe7f,5518,488,4825,20,10851,Gwinnett080d771436aaf096f46596fc022609ee66f721f5bfcb7a68c0ff9005594dfe7f
DeKalb,64d5fd62bb29eef9a4c2840503be2f519eb9f9d3353624ea27a1d22a38485210,9711,1271,7696,9,18687,DeKalb64d5fd62bb29eef9a4c2840503be2f519eb9f9d3353624ea27a1d22a38485210
DeKalb,6922022d4d52efc209e27a7277c2c1cf206148887aee0c6366d00d8fd0d3157d,24373,3701,34034,38,62146,DeKalb6922022d4d52efc209e27a7277c2c1cf206148887aee0c6366d00d8fd0d3157d
DeKalb,33094e5fbd99e1230f05e153e947cc0126286c535ab99bbbfd28b277edda7581,421,78,555,0,1054,DeKalb33094e5fbd99e1230f05e153e947cc0126286c535ab99bbbfd28b277edda7581
Newton,33094e5fbd99e1230f05e153e947cc0126286c535ab99bbbfd28b277edda7581,4447,526,4662,1,9636,Newton33094e5fbd99e1230f05e153e947cc0126286c535ab99bbbfd28b277edda7581
Rockdale,33094e5fbd99e1230f05e153e947cc0126286c535ab99bbbfd28b277edda7581,2776,534,7171,4,10485,Rockdale33094e5fbd99e1230f05e153e947cc0126286c535ab99bbbfd28b277edda7581
DeKalb,c1b32a665ce73e38c950d308899fa457268bd912951c20ca8f6f51c2c16effbe,5786,588,10923,8,17305,DeKalbc1b32a665ce73e38c950d308899fa457268bd912951c20ca8f6f51c2c16effbe
Newton,c1b32a665ce73e38c950d308899fa457268bd912951c20ca8f6f51c2c16effbe,6219,681,8611,2,15513,Newtonc1b32a665ce73e38c950d308899fa457268bd912951c20ca8f6f51c2c16effbe
Rockdale,c1b32a665ce73e38c950d308899fa457268bd912951c20ca8f6f51c2c16effbe,4802,579,12219,18,17618,Rockdalec1b32a665ce73e38c950d308899fa457268bd912951c20ca8f6f51c2c16effbe
Clayton,95c5f7d7302ed9d371c123cba45b80fd2014a963757ba839d3170b78e61fdea0,13941,1311,28059,49,43360,Clayton95c5f7d7302ed9d371c123cba45b80fd2014a963757ba839d3170b78e61fdea0
DeKalb,95c5f7d7302ed9d371c123cba45b80fd2014a963757ba839d3170b78e61fdea0,8628,801,13242,19,22690,DeKalb95c5f7d7302ed9d371c123cba45b80fd2014a963757ba839d3170b78e61fdea0
Gwinnett,0e788d23101de15e031dbe739cb1a35f5367dfa9473c640dd73081a6d90eca6b,31823,3529,28506,201,64059,Gwinnett0e788d23101de15e031dbe739cb1a35f5367dfa9473c640dd73081a6d90eca6b
Clarke,1c9d565d910ecdf18ee8c7397e0a1e65c66459848a02c43810e9938ee9021488,7394,1002,8487,19,16902,Clarke1c9d565d910ecdf18ee8c7397e0a1e65c66459848a02c43810e9938ee9021488
Oconee,1c9d565d910ecdf18ee8c7397e0a1e65c66459848a02c43810e9938ee9021488,6520,664,9540,8,16732,Oconee1c9d565d910ecdf18ee8c7397e0a1e65c66459848a02c43810e9938ee9021488
Walton,1c9d565d910ecdf18ee8c7397e0a1e65c66459848a02c43810e9938ee9021488,14634,1195,13087,15,28931,Walton1c9d565d910ecdf18ee8c7397e0a1e65c66459848a02c43810e9938ee9021488
Barrow,5d684b68e40441bc5c694a571ba76546548ef2410cd602c16d7fec59f2703a97,10745,931,12850,1,24527,Barrow5d684b68e40441bc5c694a571ba76546548ef2410cd602c16d7fec59f2703a97
Clarke,5d684b68e40441bc5c694a571ba76546548ef2410cd602c16d7fec59f2703a97,4929,610,4665,13,10217,Clarke5d684b68e40441bc5c694a571ba76546548ef2410cd602c16d7fec59f2703a97
Jackson,5d684b68e40441bc5c694a571ba76546548ef2410cd602c16d7fec59f2703a97,4831,373,7771,14,12989,Jackson5d684b68e40441bc5c694a571ba76546548ef2410cd602c16d7fec59f2703a97
Madison,5d684b68e40441bc5c694a571ba76546548ef2410cd602c16d7fec59f2703a97,4491,404,5203,6,10104,Madison5d684b68e40441bc5c694a571ba76546548ef2410cd602c16d7fec59f2703a97
Fulton,542ee52ced59dae3f98fed9b30af2266b93f872baddeeb1c1acf9c1e95234a5a,5735,1273,12535,26,19569,Fulton542ee52ced59dae3f98fed9b30af2266b93f872baddeeb1c1acf9c1e95234a5a
Gwinnett,542ee52ced59dae3f98fed9b30af2266b93f872baddeeb1c1acf9c1e95234a5a,17019,2307,12591,60,31977,Gwinnett542ee52ced59dae3f98fed9b30af2266b93f872baddeeb1c1acf9c1e95234a5a
Hall,29e52700d272a5f4260246dbddf876b511fbcdb8fa36450d5fd06a6406b0f6d3,27428,2827,28939,48,59242,Hall29e52700d272a5f4260246dbddf876b511fbcdb8fa36450d5fd06a6406b0f6d3
Banks,7e09a665c485ae7b187eb19f64751ac7ff699d508048dab9ebbdeb2be342e30d,3186,187,2893,1,6267,Banks7e09a665c485ae7b187eb19f64751ac7ff699d508048dab9ebbdeb2be342e30d
Franklin,7e09a665c485ae7b187eb19f64751ac7ff699d508048dab9ebbdeb2be342e30d,3651,336,3540,0,7527,Franklin7e09a665c485ae7b187eb19f64751ac7ff699d508048dab9ebbdeb2be342e30d
Habersham,7e09a665c485ae7b187eb19f64751ac7ff699d508048dab9ebbdeb2be342e30d,2870,773,10340,3,13986,Habersham7e09a665c485ae7b187eb19f64751ac7ff699d508048dab9ebbdeb2be342e30d
Hall,7e09a665c485ae7b187eb19f64751ac7ff699d508048dab9ebbdeb2be342e30d,866,51,461,0,1378,Hall7e09a665c485ae7b187eb19f64751ac7ff699d508048dab9ebbdeb2be342e30d
Jackson,7e09a665c485ae7b187eb19f64751ac7ff699d508048dab9ebbdeb2be342e30d,3952,310,6838,19,11119,Jackson7e09a665c485ae7b187eb19f64751ac7ff699d508048dab9ebbdeb2be342e30d
Rabun,7e09a665c485ae7b187eb19f64751ac7ff699d508048dab9ebbdeb2be342e30d,1179,730,4727,0,6636,Rabun7e09a665c485ae7b187eb19f64751ac7ff699d508048dab9ebbdeb2be342e30d
Stephens,7e09a665c485ae7b187eb19f64751ac7ff699d508048dab9ebbdeb2be342e30d,1780,550,6331,3,8664,Stephens7e09a665c485ae7b187eb19f64751ac7ff699d508048dab9ebbdeb2be342e30d
Towns,7e09a665c485ae7b187eb19f64751ac7ff699d508048dab9ebbdeb2be342e30d,1527,301,3766,9,5603,Towns7e09a665c485ae7b187eb19f64751ac7ff699d508048dab9ebbdeb2be342e30d
Dawson,321ff10a718e05d5e650b067c3292d2b54fbf77d3e6ddce95d17b46e01d58364,2667,434,7175,15,10291,Dawson321ff10a718e05d5e650b067c3292d2b54fbf77d3e6ddce95d17b46e01d58364
Fannin,321ff10a718e05d5e650b067c3292d2b54fbf77d3e6ddce95d17b46e01d58364,4355,623,4883,6,9867,Fannin321ff10a718e05d5e650b067c3292d2b54fbf77d3e6ddce95d17b46e01d58364
Forsyth,321ff10a718e05d5e650b067c3292d2b54fbf77d3e6ddce95d17b46e01d58364,275,15,661,0,951,Forsyth321ff10a718e05d5e650b067c3292d2b54fbf77d3e6ddce95d17b46e01d58364
Gilmer,321ff10a718e05d5e650b067c3292d2b54fbf77d3e6ddce95d17b46e01d58364,4456,528,5603,9,10596,Gilmer321ff10a718e05d5e650b067c3292d2b54fbf77d3e6ddce95d17b46e01d58364
Lumpkin,321ff10a718e05d5e650b067c3292d2b54fbf77d3e6ddce95d17b46e01d58364,2533,425,7569,5,10532,Lumpkin321ff10a718e05d5e650b067c3292d2b54fbf77d3e6ddce95d17b46e01d58364
Pickens,321ff10a718e05d5e650b067c3292d2b54fbf77d3e6ddce95d17b46e01d58364,2629,155,4637,1,7422,Pickens321ff10a718e05d5e650b067c3292d2b54fbf77d3e6ddce95d17b46e01d58364
Union,321ff10a718e05d5e650b067c3292d2b54fbf77d3e6ddce95d17b46e01d58364,3537,518,6478,3,10536,Union321ff10a718e05d5e650b067c3292d2b54fbf77d3e6ddce95d17b46e01d58364
White,321ff10a718e05d5e650b067c3292d2b54fbf77d3e6ddce95d17b46e01d58364,4401,513,5618,10,10542,White321ff10a718e05d5e650b067c3292d2b54fbf77d3e6ddce95d17b46e01d58364
Bartow,4559548d1eded867567bb46fc5309881a081b8a0000195ca893154168d46e434,7325,456,6214,3,13998,Bartow4559548d1eded867567bb46fc5309881a081b8a0000195ca893154168d46e434
Chattooga,4559548d1eded867567bb46fc5309881a081b8a0000195ca893154168d46e434,388,13,262,0,663,Chattooga4559548d1eded867567bb46fc5309881a081b8a0000195ca893154168d46e434
Floyd,4559548d1eded867567bb46fc5309881a081b8a0000195ca893154168d46e434,12087,1041,15850,88,29066,Floyd4559548d1eded867567bb46fc5309881a081b8a0000195ca893154168d46e434
Gordon,4559548d1eded867567bb46fc5309881a081b8a0000195ca893154168d46e434,3845,300,4939,9,9093,Gordon4559548d1eded867567bb46fc5309881a081b8a0000195ca893154168d46e434
Catoosa,0fb5fb0bef2c11f5663225cd5b45e9cf98542b96ef7313effc8a9482b515a5e3,7936,551,14617,13,23117,Catoosa0fb5fb0bef2c11f5663225cd5b45e9cf98542b96ef7313effc8a9482b515a5e3
Chattooga,0fb5fb0bef2c11f5663225cd5b45e9cf98542b96ef7313effc8a9482b515a5e3,2926,173,3316,5,6420,Chattooga0fb5fb0bef2c11f5663225cd5b45e9cf98542b96ef7313effc8a9482b515a5e3
Dade,0fb5fb0bef2c11f5663225cd5b45e9cf98542b96ef7313effc8a9482b515a5e3,2705,117,2416,2,5240,Dade0fb5fb0bef2c11f5663225cd5b45e9cf98542b96ef7313effc8a9482b515a5e3
Walker,0fb5fb0bef2c11f5663225cd5b45e9cf98542b96ef7313effc8a9482b515a5e3,8201,764,11395,11,20371,Walker0fb5fb0bef2c11f5663225cd5b45e9cf98542b96ef7313effc8a9482b515a5e3
Gordon,15e5d1e07f3dca7f9b7f9180e57b85bf156c5c1ea249a3d7419b01585b5c7497,3648,165,2724,9,6546,Gordon15e5d1e07f3dca7f9b7f9180e57b85bf156c5c1ea249a3d7419b01585b5c7497
Murray,15e5d1e07f3dca7f9b7f9180e57b85bf156c5c1ea249a3d7419b01585b5c7497,5368,290,4698,0,10356,Murray15e5d1e07f3dca7f9b7f9180e57b85bf156c5c1ea249a3d7419b01585b5c7497
Pickens,15e5d1e07f3dca7f9b7f9180e57b85bf156c5c1ea249a3d7419b01585b5c7497,2034,55,2399,1,4489,Pickens15e5d1e07f3dca7f9b7f9180e57b85bf156c5c1ea249a3d7419b01585b5c7497
Whitfield,15e5d1e07f3dca7f9b7f9180e57b85bf156c5c1ea249a3d7419b01585b5c7497,13386,958,11144,29,25517,Whitfield15e5d1e07f3dca7f9b7f9180e57b85bf156c5c1ea249a3d7419b01585b5c7497
DeKalb,40bde1224557458c62bbc683dd05286dacc1009fe6a723039658d85dd287de13,838,112,1106,4,2060,DeKalb40bde1224557458c62bbc683dd05286dacc1009fe6a723039658d85dd287de13
Gwinnett,40bde1224557458c62bbc683dd05286dacc1009fe6a723039658d85dd287de13,7071,1180,7352,23,15626,Gwinnett40bde1224557458c62bbc683dd05286dacc1009fe6a723039658d85dd287de13
DeKalb,f921f7a6394d45c714531385b35a8687da9d7dcd0b9a4bfac21816d99884f773,10787,1057,21744,12,33600,DeKalbf921f7a6394d45c714531385b35a8687da9d7dcd0b9a4bfac21816d99884f773
Gwinnett,f921f7a6394d45c714531385b35a8687da9d7dcd0b9a4bfac21816d99884f773,11212,979,16020,96,28307,Gwinnettf921f7a6394d45c714531385b35a8687da9d7dcd0b9a4bfac21816d99884f773
Cherokee,c55376e8c77693d93091b4ac3886dbb3e3236ff03440d658d7932a7bdd16aa67,1008,225,1489,1,2723,Cherokeec55376e8c77693d93091b4ac3886dbb3e3236ff03440d658d7932a7bdd16aa67
Fulton,c55376e8c77693d93091b4ac3886dbb3e3236ff03440d658d7932a7bdd16aa67,14497,2939,28995,48,46479,Fultonc55376e8c77693d93091b4ac3886dbb3e3236ff03440d658d7932a7bdd16aa67
Cherokee,9598d064106db853c6bd6d4f1160ca151c1e688203d02f6afa13baf7b098c45e,422,100,671,0,1193,Cherokee9598d064106db853c6bd6d4f1160ca151c1e688203d02f6afa13baf7b098c45e
Fulton,9598d064106db853c6bd6d4f1160ca151c1e688203d02f6afa13baf7b098c45e,8939,1531,21250,56,31776,Fulton9598d064106db853c6bd6d4f1160ca151c1e688203d02f6afa13baf7b098c45e
Dade,0f2b861e91f3a7215c5de93d44c97ae57229e1848b4ef3c1adb9a8548ca69b1e,2665,117,2366,2,5150,Dade0f2b861e91f3a7215c5de93d44c97ae57229e1848b4ef3c1adb9a8548ca69b1e
Walker,0f2b861e91f3a7215c5de93d44c97ae57229e1848b4ef3c1adb9a8548ca69b1e,4665,434,5531,6,10636,Walker0f2b861e91f3a7215c5de93d44c97ae57229e1848b4ef3c1adb9a8548ca69b1e
Catoosa,d9639e926b51c1f5c0c86116057def299f0bc852c72fdecdca219558cc234bf0,1697,66,2217,2,3982,Catoosad9639e926b51c1f5c0c86116057def299f0bc852c72fdecdca219558cc234bf0
Walker,d9639e926b51c1f5c0c86116057def299f0bc852c72fdecdca219558cc234bf0,3577,352,5979,4,9912,Walkerd9639e926b51c1f5c0c86116057def299f0bc852c72fdecdca219558cc234bf0
Whitfield,d9639e926b51c1f5c0c86116057def299f0bc852c72fdecdca219558cc234bf0,2253,146,1644,1,4044,Whitfieldd9639e926b51c1f5c0c86116057def299f0bc852c72fdecdca219558cc234bf0
Catoosa,d38c04ee1231a32454561b026e3fac01c0557b9f1a6b5787208bd58bcc5ac25a,6218,485,12360,8,19071,Catoosad38c04ee1231a32454561b026e3fac01c0557b9f1a6b5787208bd58bcc5ac25a
Whitfield,3d33b42dc74ea61eb63587eedb1efc1ffc21d5ac06ebf7bb333e6b2854a4b876,5883,479,4957,16,11335,Whitfield3d33b42dc74ea61eb63587eedb1efc1ffc21d5ac06ebf7bb333e6b2854a4b876
Gordon,4753034fb70e5c612fb8bb73aac5d33a55db4095a68d2f81fe723e87b45de307,6111,402,6937,13,13463,Gordon4753034fb70e5c612fb8bb73aac5d33a55db4095a68d2f81fe723e87b45de307
Murray,4753034fb70e5c612fb8bb73aac5d33a55db4095a68d2f81fe723e87b45de307,786,31,533,0,1350,Murray4753034fb70e5c612fb8bb73aac5d33a55db4095a68d2f81fe723e87b45de307
Murray,5a2ec6b01ff77a4a6cc3c12e1f881f3461a746c135b9884dd7c92b5cf9b70c9d,2543,114,1983,0,4640,Murray5a2ec6b01ff77a4a6cc3c12e1f881f3461a746c135b9884dd7c92b5cf9b70c9d
Whitfield,5a2ec6b01ff77a4a6cc3c12e1f881f3461a746c135b9884dd7c92b5cf9b70c9d,5203,335,4466,10,10014,Whitfield5a2ec6b01ff77a4a6cc3c12e1f881f3461a746c135b9884dd7c92b5cf9b70c9d
Dawson,6b91ba9d5b9e3e99402a6b21c8762d70a9608f0386a0351ad55c1d06ec9f53b1,462,88,783,0,1333,Dawson6b91ba9d5b9e3e99402a6b21c8762d70a9608f0386a0351ad55c1d06ec9f53b1
Fannin,6b91ba9d5b9e3e99402a6b21c8762d70a9608f0386a0351ad55c1d06ec9f53b1,4258,625,4839,6,9728,Fannin6b91ba9d5b9e3e99402a6b21c8762d70a9608f0386a0351ad55c1d06ec9f53b1
Gilmer,6b91ba9d5b9e3e99402a6b21c8762d70a9608f0386a0351ad55c1d06ec9f53b1,4452,531,5613,9,10605,Gilmer6b91ba9d5b9e3e99402a6b21c8762d70a9608f0386a0351ad55c1d06ec9f53b1
Rabun,f98f74a6f091a4b6b3b42337bfe55c758bcd5494ec6b12badd840986f1e9133c,1194,747,4738,0,6679,Rabunf98f74a6f091a4b6b3b42337bfe55c758bcd5494ec6b12badd840986f1e9133c
Towns,f98f74a6f091a4b6b3b42337bfe55c758bcd5494ec6b12badd840986f1e9133c,1525,306,3759,10,5600,Townsf98f74a6f091a4b6b3b42337bfe55c758bcd5494ec6b12badd840986f1e9133c
Union,f98f74a6f091a4b6b3b42337bfe55c758bcd5494ec6b12badd840986f1e9133c,3418,505,6322,3,10248,Unionf98f74a6f091a4b6b3b42337bfe55c758bcd5494ec6b12badd840986f1e9133c
White,f98f74a6f091a4b6b3b42337bfe55c758bcd5494ec6b12badd840986f1e9133c,1049,97,1150,1,2297,Whitef98f74a6f091a4b6b3b42337bfe55c758bcd5494ec6b12badd840986f1e9133c
Dawson,75a2766554ed28e13e2ce1362574a1f51888368632fbf0c95dd7c7d58ec1c320,2202,344,6425,15,8986,Dawson75a2766554ed28e13e2ce1362574a1f51888368632fbf0c95dd7c7d58ec1c320
Forsyth,75a2766554ed28e13e2ce1362574a1f51888368632fbf0c95dd7c7d58ec1c320,436,44,1141,1,1622,Forsyth75a2766554ed28e13e2ce1362574a1f51888368632fbf0c95dd7c7d58ec1c320
Lumpkin,75a2766554ed28e13e2ce1362574a1f51888368632fbf0c95dd7c7d58ec1c320,2533,442,7704,6,10685,Lumpkin75a2766554ed28e13e2ce1362574a1f51888368632fbf0c95dd7c7d58ec1c320
Habersham,4288a7a9d286d23d639a453d6f35a12aaaa8013dab6870fbc0be562cb9e42cbf,2280,626,7835,1,10742,Habersham4288a7a9d286d23d639a453d6f35a12aaaa8013dab6870fbc0be562cb9e42cbf
White,4288a7a9d286d23d639a453d6f35a12aaaa8013dab6870fbc0be562cb9e42cbf,2960,394,4063,9,7426,White4288a7a9d286d23d639a453d6f35a12aaaa8013dab6870fbc0be562cb9e42cbf
Gordon,7cf9472fd30dd5c49220366aeee5d99ce27e7c3bd310c72320bbc1013bb163b4,1468,78,904,3,2453,Gordon7cf9472fd30dd5c49220366aeee5d99ce27e7c3bd310c72320bbc1013bb163b4
Murray,7cf9472fd30dd5c49220366aeee5d99ce27e7c3bd310c72320bbc1013bb163b4,1778,126,1938,0,3842,Murray7cf9472fd30dd5c49220366aeee5d99ce27e7c3bd310c72320bbc1013bb163b4
Pickens,7cf9472fd30dd5c49220366aeee5d99ce27e7c3bd310c72320bbc1013bb163b4,4553,218,6934,0,11705,Pickens7cf9472fd30dd5c49220366aeee5d99ce27e7c3bd310c72320bbc1013bb163b4
Gordon,7af4d57af270d80d789a427ed1ecef7e7ceba7a89301e37b60a518d1d50cd659,252,11,160,1,424,Gordon7af4d57af270d80d789a427ed1ecef7e7ceba7a89301e37b60a518d1d50cd659
Murray,7af4d57af270d80d789a427ed1ecef7e7ceba7a89301e37b60a518d1d50cd659,514,52,500,0,1066,Murray7af4d57af270d80d789a427ed1ecef7e7ceba7a89301e37b60a518d1d50cd659
Pickens,7af4d57af270d80d789a427ed1ecef7e7ceba7a89301e37b60a518d1d50cd659,624,54,1143,2,1823,Pickens7af4d57af270d80d789a427ed1ecef7e7ceba7a89301e37b60a518d1d50cd659
Chattooga,f14f373f607c7e77aee9dd2e44e546afac9382d867a1fd50933292d1eea45389,3335,184,3571,4,7094,Chattoogaf14f373f607c7e77aee9dd2e44e546afac9382d867a1fd50933292d1eea45389
Floyd,f14f373f607c7e77aee9dd2e44e546afac9382d867a1fd50933292d1eea45389,4331,230,4195,30,8786,Floydf14f373f607c7e77aee9dd2e44e546afac9382d867a1fd50933292d1eea45389
Floyd,c06d0d2124ecd7c3b83ab35ae4527574082dc76952dbf43969936323fee5515a,5494,631,8325,26,14476,Floydc06d0d2124ecd7c3b83ab35ae4527574082dc76952dbf43969936323fee5515a
Bartow,b969dd6f1ae2b6b46f95fb0d0c88c629f149acaa934006b0d3ee4d368fd12fff,7499,444,5219,4,13166,Bartowb969dd6f1ae2b6b46f95fb0d0c88c629f149acaa934006b0d3ee4d368fd12fff
Floyd,b969dd6f1ae2b6b46f95fb0d0c88c629f149acaa934006b0d3ee4d368fd12fff,2211,159,3110,31,5511,Floydb969dd6f1ae2b6b46f95fb0d0c88c629f149acaa934006b0d3ee4d368fd12fff
Bartow,8602eea4bdfb299cb50dbdd20ee03be13ba32a6857d67dd2b1f6590c5095dc64,6961,610,7604,7,15182,Bartow8602eea4bdfb299cb50dbdd20ee03be13ba32a6857d67dd2b1f6590c5095dc64
Bartow,174962120ed1e5e93f66970069db031211f9b9dcf334dc7d91e8350b4fd8ce3b,2320,237,2287,5,4849,Bartow174962120ed1e5e93f66970069db031211f9b9dcf334dc7d91e8350b4fd8ce3b
Bartow,1426432e342da06db6bf16c319616abe91703e3064eeae40d05b6faf1160fffd,1979,73,1073,1,3126,Bartow1426432e342da06db6bf16c319616abe91703e3064eeae40d05b6faf1160fffd
Haralson,1426432e342da06db6bf16c319616abe91703e3064eeae40d05b6faf1160fffd,1055,56,657,0,1768,Haralson1426432e342da06db6bf16c319616abe91703e3064eeae40d05b6faf1160fffd
Polk,1426432e342da06db6bf16c319616abe91703e3064eeae40d05b6faf1160fffd,3969,407,8019,7,12402,Polk1426432e342da06db6bf16c319616abe91703e3064eeae40d05b6faf1160fffd
Paulding,9de252561eec8c80c766c4c1d0c4b11b8f82216599afb110d721fbccd89197f2,5960,929,13521,5,20415,Paulding9de252561eec8c80c766c4c1d0c4b11b8f82216599afb110d721fbccd89197f2
Carroll,2871ea6eb8e9e685688b38d41388bf379253e8e6d4deeccd00a5e05b1cc22dc2,3370,254,4583,11,8218,Carroll2871ea6eb8e9e685688b38d41388bf379253e8e6d4deeccd00a5e05b1cc22dc2
Haralson,2871ea6eb8e9e685688b38d41388bf379253e8e6d4deeccd00a5e05b1cc22dc2,3959,322,3968,7,8256,Haralson2871ea6eb8e9e685688b38d41388bf379253e8e6d4deeccd00a5e05b1cc22dc2
Paulding,3c9814f830d47593bc19d9c57b0c37e98c44d8f84ecb397580070b9bbfdfc3df,5866,979,12953,4,19802,Paulding3c9814f830d47593bc19d9c57b0c37e98c44d8f84ecb397580070b9bbfdfc3df
Cherokee,e6046ecf48ccae89487c9917782f3e3fa0e3677bb0936b80185f10b17c4f8d02,9830,1092,12618,3,23543,Cherokeee6046ecf48ccae89487c9917782f3e3fa0e3677bb0936b80185f10b17c4f8d02
Cherokee,70e332310c90cf6bee97561816cf2d8bfd1daad26561c5ea39465dee629a3322,9492,1056,13413,6,23967,Cherokee70e332310c90cf6bee97561816cf2d8bfd1daad26561c5ea39465dee629a3322
Cherokee,a5a373b9aa1ba5f0d11ba30bb153846f27bde45bca1fc3ee1b549580ceaad047,6369,734,10524,1,17628,Cherokeea5a373b9aa1ba5f0d11ba30bb153846f27bde45bca1fc3ee1b549580ceaad047
Forsyth,a5a373b9aa1ba5f0d11ba30bb153846f27bde45bca1fc3ee1b549580ceaad047,2010,238,4312,4,6564,Forsytha5a373b9aa1ba5f0d11ba30bb153846f27bde45bca1fc3ee1b549580ceaad047
Fulton,a5a373b9aa1ba5f0d11ba30bb153846f27bde45bca1fc3ee1b549580ceaad047,579,41,982,0,1602,Fultona5a373b9aa1ba5f0d11ba30bb153846f27bde45bca1fc3ee1b549580ceaad047
Cherokee,2382ade9e3a01dfa905515b60227cfefc4e941028591ed83a716098c6256870a,890,133,1446,0,2469,Cherokee2382ade9e3a01dfa905515b60227cfefc4e941028591ed83a716098c6256870a
Forsyth,2382ade9e3a01dfa905515b60227cfefc4e941028591ed83a716098c6256870a,879,103,1481,1,2464,Forsyth2382ade9e3a01dfa905515b60227cfefc4e941028591ed83a716098c6256870a
Fulton,2382ade9e3a01dfa905515b60227cfefc4e941028591ed83a716098c6256870a,67,11,204,1,283,Fulton2382ade9e3a01dfa905515b60227cfefc4e941028591ed83a716098c6256870a
Cherokee,f7860a403ba6dbbbf5fe036163f5ed8880b67d086faf8dcc60b7ba9e774aabff,9164,813,10963,4,20944,Cherokeef7860a403ba6dbbbf5fe036163f5ed8880b67d086faf8dcc60b7ba9e774aabff
Forsyth,001f230e9ff2a962e3191fb08e98189db371338a46a2bc31d493c0445fe146c2,6169,860,18959,8,25996,Forsyth001f230e9ff2a962e3191fb08e98189db371338a46a2bc31d493c0445fe146c2
Forsyth,f0bba45b4bb0c636efc15fee7e51e19b4942285845281896a3d932277b494ebf,5630,1130,16764,5,23529,Forsythf0bba45b4bb0c636efc15fee7e51e19b4942285845281896a3d932277b494ebf
Fulton,f0bba45b4bb0c636efc15fee7e51e19b4942285845281896a3d932277b494ebf,609,274,1749,1,2633,Fultonf0bba45b4bb0c636efc15fee7e51e19b4942285845281896a3d932277b494ebf
Forsyth,a6e3fdf94df46d59d0de937c1803e143de213dfe5a24612030ecb372541db436,7818,916,17640,12,26386,Forsytha6e3fdf94df46d59d0de937c1803e143de213dfe5a24612030ecb372541db436
Hall,354c27c6ed2fdce81edbdbdc186de86a372ed65a792463859c02b78f871dea10,9369,752,8604,4,18729,Hall354c27c6ed2fdce81edbdbdc186de86a372ed65a792463859c02b78f871dea10
White,354c27c6ed2fdce81edbdbdc186de86a372ed65a792463859c02b78f871dea10,366,27,347,0,740,White354c27c6ed2fdce81edbdbdc186de86a372ed65a792463859c02b78f871dea10
Banks,426fc9755cddab5d06ff0997bb45cf1a93fb4fc36000c8b6ec4afe725ad49753,3158,188,2888,1,6235,Banks426fc9755cddab5d06ff0997bb45cf1a93fb4fc36000c8b6ec4afe725ad49753
Habersham,426fc9755cddab5d06ff0997bb45cf1a93fb4fc36000c8b6ec4afe725ad49753,588,171,2461,2,3222,Habersham426fc9755cddab5d06ff0997bb45cf1a93fb4fc36000c8b6ec4afe725ad49753
Stephens,426fc9755cddab5d06ff0997bb45cf1a93fb4fc36000c8b6ec4afe725ad49753,1763,543,6159,3,8468,Stephens426fc9755cddab5d06ff0997bb45cf1a93fb4fc36000c8b6ec4afe725ad49753
Hall,9833741c68c020cbcc1f623a84cf1d1b601d5821878cf9cc49b9d393f5e8e0d0,5149,815,6760,9,12733,Hall9833741c68c020cbcc1f623a84cf1d1b601d5821878cf9cc49b9d393f5e8e0d0
Hall,6f639916040354e81f2a43b8c6afba88a02668862d13db8a574582bc0054cfcd,7138,631,7338,8,15115,Hall6f639916040354e81f2a43b8c6afba88a02668862d13db8a574582bc0054cfcd
Hall,9d0352ee858cc363fd1a7cf2d9ddb38b498c3d4e9bb1cf697c490c865cd1b2b5,2625,239,2433,5,5302,Hall9d0352ee858cc363fd1a7cf2d9ddb38b498c3d4e9bb1cf697c490c865cd1b2b5
Jackson,53197f131e9d866e6c74fc593b8ee8bbbbf3b8090a83299d424632b8b854e53a,7526,598,13651,35,21810,Jackson53197f131e9d866e6c74fc593b8ee8bbbbf3b8090a83299d424632b8b854e53a
Franklin,0d46f7102977cec719551ff002aa94abae3ebb3104fe511b085442b7fbd8e2a5,3693,343,3591,0,7627,Franklin0d46f7102977cec719551ff002aa94abae3ebb3104fe511b085442b7fbd8e2a5
Hart,0d46f7102977cec719551ff002aa94abae3ebb3104fe511b085442b7fbd8e2a5,3653,403,4554,1,8611,Hart0d46f7102977cec719551ff002aa94abae3ebb3104fe511b085442b7fbd8e2a5
Madison,0d46f7102977cec719551ff002aa94abae3ebb3104fe511b085442b7fbd8e2a5,1250,96,1199,0,2545,Madison0d46f7102977cec719551ff002aa94abae3ebb3104fe511b085442b7fbd8e2a5
Columbia,593733bd62f814b4d6313145568a705f15c545f124e639ff22bb0d48cd6a1ccd,357,17,230,0,604,Columbia593733bd62f814b4d6313145568a705f15c545f124e639ff22bb0d48cd6a1ccd
Elbert,593733bd62f814b4d6313145568a705f15c545f124e639ff22bb0d48cd6a1ccd,2510,400,3831,45,6786,Elbert593733bd62f814b4d6313145568a705f15c545f124e639ff22bb0d48cd6a1ccd
Lincoln,593733bd62f814b4d6313145568a705f15c545f124e639ff22bb0d48cd6a1ccd,1295,219,1682,1,3197,Lincoln593733bd62f814b4d6313145568a705f15c545f124e639ff22bb0d48cd6a1ccd
Madison,593733bd62f814b4d6313145568a705f15c545f124e639ff22bb0d48cd6a1ccd,3247,307,3985,3,7542,Madison593733bd62f814b4d6313145568a705f15c545f124e639ff22bb0d48cd6a1ccd
Wilkes,593733bd62f814b4d6313145568a705f15c545f124e639ff22bb0d48cd6a1ccd,494,35,530,2,1061,Wilkes593733bd62f814b4d6313145568a705f15c545f124e639ff22bb0d48cd6a1ccd
Cobb,e49110b3a06ff8aece62928b6b45172b965d978be0149316820a013d2ac410ef,7930,1116,6827,13,15886,Cobbe49110b3a06ff8aece62928b6b45172b965d978be0149316820a013d2ac410ef
Cobb,488e4a653158cfb4a9150be082eeca0e594c99bf51339fbca9ad8e7cd7b17ef6,4255,522,4258,15,9050,Cobb488e4a653158cfb4a9150be082eeca0e594c99bf51339fbca9ad8e7cd7b17ef6
Cobb,37277c2a95af180a317240782ceabe835c93c11a4f790425a2cbeaf0b90e69da,11207,1106,6567,21,18901,Cobb37277c2a95af180a317240782ceabe835c93c11a4f790425a2cbeaf0b90e69da
Cobb,f9ce4817c834d3152f5e2f8ce8c92715368949bbd2fee1affce466202d8a45ed,12820,1757,12213,17,26807,Cobbf9ce4817c834d3152f5e2f8ce8c92715368949bbd2fee1affce466202d8a45ed
Cobb,1f5922205951e2d43f3fbff8729b05a0f1477333c27d05c3ba784869dec06f11,6881,996,6079,9,13965,Cobb1f5922205951e2d43f3fbff8729b05a0f1477333c27d05c3ba784869dec06f11
Cobb,8959c6230d2ac49812c4412a1fb93e477bc833403461cdd0143d64823a72ed58,4639,557,5349,22,10567,Cobb8959c6230d2ac49812c4412a1fb93e477bc833403461cdd0143d64823a72ed58
Cobb,aa087756092c0e51e6915129139e306514272ecdb5d1895521ea7201a75b93c0,8438,985,10096,28,19547,Cobbaa087756092c0e51e6915129139e306514272ecdb5d1895521ea7201a75b93c0
Cobb,fe7af4644c0dbd1cdca1674b636584aa06a67022fc0b9a46748b5020cd6cde2e,7647,716,9710,24,18097,Cobbfe7af4644c0dbd1cdca1674b636584aa06a67022fc0b9a46748b5020cd6cde2e
Cobb,26f2dd90e465a7137e6822ea591ded429cb0d497dc84b540d8c45c065d6670a2,7697,1487,5458,14,14656,Cobb26f2dd90e465a7137e6822ea591ded429cb0d497dc84b540d8c45c065d6670a2
Fulton,26f2dd90e465a7137e6822ea591ded429cb0d497dc84b540d8c45c065d6670a2,422,74,711,0,1207,Fulton26f2dd90e465a7137e6822ea591ded429cb0d497dc84b540d8c45c065d6670a2
Cobb,f3a33ddedd6c56e88bbd4779ac3a64a0666320fc2f3b260aaa7da9197a68c49f,5726,999,6329,27,13081,Cobbf3a33ddedd6c56e88bbd4779ac3a64a0666320fc2f3b260aaa7da9197a68c49f
Fulton,f3a33ddedd6c56e88bbd4779ac3a64a0666320fc2f3b260aaa7da9197a68c49f,199,42,459,0,700,Fultonf3a33ddedd6c56e88bbd4779ac3a64a0666320fc2f3b260aaa7da9197a68c49f
Cobb,19c8bfd2cdadba83fbc5df9a7b7bc6ea767772a93ee0c610e671d90354c1c95f,6619,703,6503,18,13843,Cobb19c8bfd2cdadba83fbc5df9a7b7bc6ea767772a93ee0c610e671d90354c1c95f
Cobb,7973df20ba389cf3e7675feebc0c7db70f6bb7e2a6c242fe5f91b0bcbf00a751,2172,304,1668,13,4157,Cobb7973df20ba389cf3e7675feebc0c7db70f6bb7e2a6c242fe5f91b0bcbf00a751
Cobb,1f277a7ead7d769f36fdab91e74102b3c6877bd560ba612f6f4491ee71d275a6,5536,593,5212,43,11384,Cobb1f277a7ead7d769f36fdab91e74102b3c6877bd560ba612f6f4491ee71d275a6
Cobb,4532962fe527a52e5391b1a256ddaf7f1e029e45b195469f5fee81304dad766d,11984,1760,7115,30,20889,Cobb4532962fe527a52e5391b1a256ddaf7f1e029e45b195469f5fee81304dad766d
Cobb,08309d759aa10429e6c640c7c701544a4fa8cb786a150538e56518ba8db4eb92,11991,1680,8064,24,21759,Cobb08309d759aa10429e6c640c7c701544a4fa8cb786a150538e56518ba8db4eb92
Cobb,3edefc0fa24e90be1ac5a4257604363d0e1d0e8695e774343d9a167eaa7a5ab7,13760,2043,6768,22,22593,Cobb3edefc0fa24e90be1ac5a4257604363d0e1d0e8695e774343d9a167eaa7a5ab7
Fulton,3edefc0fa24e90be1ac5a4257604363d0e1d0e8695e774343d9a167eaa7a5ab7,751,124,1436,3,2314,Fulton3edefc0fa24e90be1ac5a4257604363d0e1d0e8695e774343d9a167eaa7a5ab7
Cherokee,938712dc149ed2ce65f40aa9ac146b2690f01ebc5a5f6710aa8273022c676948,3499,506,3877,1,7883,Cherokee938712dc149ed2ce65f40aa9ac146b2690f01ebc5a5f6710aa8273022c676948
Cobb,938712dc149ed2ce65f40aa9ac146b2690f01ebc5a5f6710aa8273022c676948,9842,1276,5722,13,16853,Cobb938712dc149ed2ce65f40aa9ac146b2690f01ebc5a5f6710aa8273022c676948
Fulton,f3210e11a5a6364292e44eec2ec141d5d0880cde231552e6cea3264fae17f983,7324,1417,14851,30,23622,Fultonf3210e11a5a6364292e44eec2ec141d5d0880cde231552e6cea3264fae17f983
Fulton,da28370f393aa62fe1d3dfbc95e88358569dfe5cd53f8f8f6d24ffc5e3bc247b,6254,1097,10512,23,17886,Fultonda28370f393aa62fe1d3dfbc95e88358569dfe5cd53f8f8f6d24ffc5e3bc247b
Fulton,b747a817ec87419dc18be89db29736440b236a279ba33b4d05aa2c4d80664126,5918,1152,13511,18,20599,Fultonb747a817ec87419dc18be89db29736440b236a279ba33b4d05aa2c4d80664126
Fulton,e82c05217f2ff28481d198f9dcbb3024578d579ccef44bef79ee1873209d418e,5250,1099,11430,23,17802,Fultone82c05217f2ff28481d198f9dcbb3024578d579ccef44bef79ee1873209d418e
Fulton,98e17713c7214f674fea84623501ef59ed6b82908408386dce00cecc8ea6859f,6005,1033,12162,10,19210,Fulton98e17713c7214f674fea84623501ef59ed6b82908408386dce00cecc8ea6859f
Fulton,5d9e3a260744ab58b6fba4599479904b34f6c58ec6ffe964d23afb566cb5b02e,6635,1220,13359,49,21263,Fulton5d9e3a260744ab58b6fba4599479904b34f6c58ec6ffe964d23afb566cb5b02e
Cobb,6261f828a51bb2cdb09193c3f727fb4c6e3dc8aba4b401b74add9d6cd690323b,2096,311,2287,9,4703,Cobb6261f828a51bb2cdb09193c3f727fb4c6e3dc8aba4b401b74add9d6cd690323b
Fulton,6261f828a51bb2cdb09193c3f727fb4c6e3dc8aba4b401b74add9d6cd690323b,6027,832,9029,26,15914,Fulton6261f828a51bb2cdb09193c3f727fb4c6e3dc8aba4b401b74add9d6cd690323b
Fulton,4428db6cc668d52a447a511ab8cedffba625fc54d2e4c29f64121807ecf39a0c,7019,1175,9407,19,17620,Fulton4428db6cc668d52a447a511ab8cedffba625fc54d2e4c29f64121807ecf39a0c
Fulton,928be26d0c1f4da0882a11a4c1b397653a2f1463e75fa94539b2b2efc6214a87,3671,838,6947,16,11472,Fulton928be26d0c1f4da0882a11a4c1b397653a2f1463e75fa94539b2b2efc6214a87
Fulton,9d10810ce120da0dfa907cee19598a8af7dae66ddbd20106bcd9a61bfaacefdc,8026,954,14098,33,23111,Fulton9d10810ce120da0dfa907cee19598a8af7dae66ddbd20106bcd9a61bfaacefdc
Fulton,b0c623176cd857d00ccdcc1ddc028f565c394eee623053512ee65fbe782d7af7,8587,681,7334,81,16683,Fultonb0c623176cd857d00ccdcc1ddc028f565c394eee623053512ee65fbe782d7af7
Fulton,9048c9674fe4708f9d19d812fcf19959069c15b53996f011b34b44d22be78c29,11110,1053,11522,147,23832,Fulton9048c9674fe4708f9d19d812fcf19959069c15b53996f011b34b44d22be78c29
Fulton,3e0107a037bf4da548d67b5a5c911aca63c203620d3e6f403ca0bb425e5d8116,11459,800,10981,47,23287,Fulton3e0107a037bf4da548d67b5a5c911aca63c203620d3e6f403ca0bb425e5d8116
Fulton,a665f7478219c93604fef838367955c84afc185cc9b7e60a5e4194fdc72c214d,10035,681,9513,47,20276,Fultona665f7478219c93604fef838367955c84afc185cc9b7e60a5e4194fdc72c214d
Clayton,a1171df81ee0f0e2fabddfc5504b39e1071dc12710e8974013da90231bc9874b,275,35,234,0,544,Claytona1171df81ee0f0e2fabddfc5504b39e1071dc12710e8974013da90231bc9874b
Fulton,a1171df81ee0f0e2fabddfc5504b39e1071dc12710e8974013da90231bc9874b,396,49,454,0,899,Fultona1171df81ee0f0e2fabddfc5504b39e1071dc12710e8974013da90231bc9874b
Clayton,c8fb8f835aabdb176c74d2cfa07d19df9c04bf308c27da02dab67cd67cc4da16,1837,96,1705,4,3642,Claytonc8fb8f835aabdb176c74d2cfa07d19df9c04bf308c27da02dab67cd67cc4da16
Fulton,c8fb8f835aabdb176c74d2cfa07d19df9c04bf308c27da02dab67cd67cc4da16,5148,345,6664,25,12182,Fultonc8fb8f835aabdb176c74d2cfa07d19df9c04bf308c27da02dab67cd67cc4da16
Cobb,0cd014bc7b1196acb3bf366ba24b383230a7b0e4526ef805e8ff8c885bd95761,1063,70,916,3,2052,Cobb0cd014bc7b1196acb3bf366ba24b383230a7b0e4526ef805e8ff8c885bd95761
Douglas,0cd014bc7b1196acb3bf366ba24b383230a7b0e4526ef805e8ff8c885bd95761,2728,273,3999,4,7004,Douglas0cd014bc7b1196acb3bf366ba24b383230a7b0e4526ef805e8ff8c885bd95761
Fulton,0cd014bc7b1196acb3bf366ba24b383230a7b0e4526ef805e8ff8c885bd95761,2756,393,8254,14,11417,Fulton0cd014bc7b1196acb3bf366ba24b383230a7b0e4526ef805e8ff8c885bd95761
Douglas,cd167459c5f318a7a420ccbf6bba0d2b4a688b74da67c641a2ee18ea1cfe90c8,2226,209,4506,4,6945,Douglascd167459c5f318a7a420ccbf6bba0d2b4a688b74da67c641a2ee18ea1cfe90c8
Fulton,cd167459c5f318a7a420ccbf6bba0d2b4a688b74da67c641a2ee18ea1cfe90c8,3809,400,12399,9,16617,Fultoncd167459c5f318a7a420ccbf6bba0d2b4a688b74da67c641a2ee18ea1cfe90c8
Clayton,1b0b1fef9f49356a44042b308cbdf60c3b97acb30d2141cf818c02441d37f0d6,923,87,2041,0,3051,Clayton1b0b1fef9f49356a44042b308cbdf60c3b97acb30d2141cf818c02441d37f0d6
Fayette,1b0b1fef9f49356a44042b308cbdf60c3b97acb30d2141cf818c02441d37f0d6,2832,410,6141,8,9391,Fayette1b0b1fef9f49356a44042b308cbdf60c3b97acb30d2141cf818c02441d37f0d6
Fulton,1b0b1fef9f49356a44042b308cbdf60c3b97acb30d2141cf818c02441d37f0d6,3370,193,5218,29,8810,Fulton1b0b1fef9f49356a44042b308cbdf60c3b97acb30d2141cf818c02441d37f0d6
Fayette,c6f80a56f4ba08ea3ccd8bf648da776b489df03badf28919031e1a562163da45,2410,334,5715,3,8462,Fayettec6f80a56f4ba08ea3ccd8bf648da776b489df03badf28919031e1a562163da45
Fulton,c6f80a56f4ba08ea3ccd8bf648da776b489df03badf28919031e1a562163da45,4116,324,8338,11,12789,Fultonc6f80a56f4ba08ea3ccd8bf648da776b489df03badf28919031e1a562163da45
Douglas,29968d05151e3c225aacb9f5e7fd4dfe1f63fe85d6a12db0f6cee5cf32f00e97,349,70,996,0,1415,Douglas29968d05151e3c225aacb9f5e7fd4dfe1f63fe85d6a12db0f6cee5cf32f00e97
Fulton,29968d05151e3c225aacb9f5e7fd4dfe1f63fe85d6a12db0f6cee5cf32f00e97,1012,104,1656,3,2775,Fulton29968d05151e3c225aacb9f5e7fd4dfe1f63fe85d6a12db0f6cee5cf32f00e97
Douglas,198ff672ae1845568389d88ba7da48e932f3c87d575b704b781abfaf5ad6c307,666,83,1546,0,2295,Douglas198ff672ae1845568389d88ba7da48e932f3c87d575b704b781abfaf5ad6c307
Fulton,198ff672ae1845568389d88ba7da48e932f3c87d575b704b781abfaf5ad6c307,4570,407,11809,28,16814,Fulton198ff672ae1845568389d88ba7da48e932f3c87d575b704b781abfaf5ad6c307
Douglas,a7cd87fac00410ba06e2df9ae0d48fa07552dd86ae89fe3cee991b482952d382,1978,378,4048,1,6405,Douglasa7cd87fac00410ba06e2df9ae0d48fa07552dd86ae89fe3cee991b482952d382
Paulding,a7cd87fac00410ba06e2df9ae0d48fa07552dd86ae89fe3cee991b482952d382,785,165,2500,0,3450,Pauldinga7cd87fac00410ba06e2df9ae0d48fa07552dd86ae89fe3cee991b482952d382
Douglas,535b3fd52ad2f733709bd09844492364336c7e5e57c01f7b0abfc68f1c98de09,4108,415,7076,9,11608,Douglas535b3fd52ad2f733709bd09844492364336c7e5e57c01f7b0abfc68f1c98de09
Paulding,535b3fd52ad2f733709bd09844492364336c7e5e57c01f7b0abfc68f1c98de09,775,103,1543,1,2422,Paulding535b3fd52ad2f733709bd09844492364336c7e5e57c01f7b0abfc68f1c98de09
Douglas,5cbc5524d3d7ccd1a3f5c5cae965416ee149473a54a15465fa1b6127617b3fb0,4119,475,6909,4,11507,Douglas5cbc5524d3d7ccd1a3f5c5cae965416ee149473a54a15465fa1b6127617b3fb0
Paulding,5cbc5524d3d7ccd1a3f5c5cae965416ee149473a54a15465fa1b6127617b3fb0,2373,315,4840,2,7530,Paulding5cbc5524d3d7ccd1a3f5c5cae965416ee149473a54a15465fa1b6127617b3fb0
Carroll,ffd56634f427666f92f8a155b15a1f57357e7db837ed25bffdc823d747b7114b,6684,588,9533,19,16824,Carrollffd56634f427666f92f8a155b15a1f57357e7db837ed25bffdc823d747b7114b
Douglas,ffd56634f427666f92f8a155b15a1f57357e7db837ed25bffdc823d747b7114b,704,97,1875,0,2676,Douglasffd56634f427666f92f8a155b15a1f57357e7db837ed25bffdc823d747b7114b
Carroll,709a256ecfa305748a681b9ce187fe412f892d4bbf94aadf6aa484df5ee44f4f,5257,284,4967,10,10518,Carroll709a256ecfa305748a681b9ce187fe412f892d4bbf94aadf6aa484df5ee44f4f
Heard,709a256ecfa305748a681b9ce187fe412f892d4bbf94aadf6aa484df5ee44f4f,1956,213,1394,2,3565,Heard709a256ecfa305748a681b9ce187fe412f892d4bbf94aadf6aa484df5ee44f4f
Troup,709a256ecfa305748a681b9ce187fe412f892d4bbf94aadf6aa484df5ee44f4f,2059,188,2850,32,5129,Troup709a256ecfa305748a681b9ce187fe412f892d4bbf94aadf6aa484df5ee44f4f
Carroll,3417add97d196071b87d2fa524497f01c37c53a34f6a5bd7c6c066ed1f77545a,622,31,428,0,1081,Carroll3417add97d196071b87d2fa524497f01c37c53a34f6a5bd7c6c066ed1f77545a
Coweta,3417add97d196071b87d2fa524497f01c37c53a34f6a5bd7c6c066ed1f77545a,9234,936,9421,10,19601,Coweta3417add97d196071b87d2fa524497f01c37c53a34f6a5bd7c6c066ed1f77545a
Coweta,61b38ab3bd3439db2596b1504ac6bb1ef06b7136b60076ba1d0e0724a9272ea0,7638,878,10615,1,19132,Coweta61b38ab3bd3439db2596b1504ac6bb1ef06b7136b60076ba1d0e0724a9272ea0
Fayette,61b38ab3bd3439db2596b1504ac6bb1ef06b7136b60076ba1d0e0724a9272ea0,420,47,762,0,1229,Fayette61b38ab3bd3439db2596b1504ac6bb1ef06b7136b60076ba1d0e0724a9272ea0
Coweta,ecb3e194102752b771a4da84ab3283711c695ff673ab1971ddd944de0ffabb33,2360,329,3471,1,6161,Cowetaecb3e194102752b771a4da84ab3283711c695ff673ab1971ddd944de0ffabb33
Fayette,ecb3e194102752b771a4da84ab3283711c695ff673ab1971ddd944de0ffabb33,240,30,502,0,772,Fayetteecb3e194102752b771a4da84ab3283711c695ff673ab1971ddd944de0ffabb33
Coweta,10adc5c151ec198d6c466a02bf4ac5c01b27c4e5e11fd81735f5b3a16b905cdd,2610,195,2582,1,5388,Coweta10adc5c151ec198d6c466a02bf4ac5c01b27c4e5e11fd81735f5b3a16b905cdd
Fayette,10adc5c151ec198d6c466a02bf4ac5c01b27c4e5e11fd81735f5b3a16b905cdd,6867,992,13549,5,21413,Fayette10adc5c151ec198d6c466a02bf4ac5c01b27c4e5e11fd81735f5b3a16b905cdd
Fayette,3128a052c9b1ce4293fe3914c74eb9568f8aa7c0bc5404b04423dad646d4ed8b,1780,196,2700,0,4676,Fayette3128a052c9b1ce4293fe3914c74eb9568f8aa7c0bc5404b04423dad646d4ed8b
Henry,3128a052c9b1ce4293fe3914c74eb9568f8aa7c0bc5404b04423dad646d4ed8b,892,145,2802,1,3840,Henry3128a052c9b1ce4293fe3914c74eb9568f8aa7c0bc5404b04423dad646d4ed8b
Spalding,3128a052c9b1ce4293fe3914c74eb9568f8aa7c0bc5404b04423dad646d4ed8b,2959,265,3920,1,7145,Spalding3128a052c9b1ce4293fe3914c74eb9568f8aa7c0bc5404b04423dad646d4ed8b
Fayette,1c83bbf4afd28655585df9f55cc90bfdec3d9e0bd0b582124123914203266966,522,85,1085,0,1692,Fayette1c83bbf4afd28655585df9f55cc90bfdec3d9e0bd0b582124123914203266966
Henry,1c83bbf4afd28655585df9f55cc90bfdec3d9e0bd0b582124123914203266966,1084,215,2566,3,3868,Henry1c83bbf4afd28655585df9f55cc90bfdec3d9e0bd0b582124123914203266966
Spalding,1c83bbf4afd28655585df9f55cc90bfdec3d9e0bd0b582124123914203266966,1306,121,1619,4,3050,Spalding1c83bbf4afd28655585df9f55cc90bfdec3d9e0bd0b582124123914203266966
Clayton,e0f1312b51f7a2adb9007d696528e10c73fa0bd3ce566572d33dcd7fefffca04,6091,448,8437,19,14995,Claytone0f1312b51f7a2adb9007d696528e10c73fa0bd3ce566572d33dcd7fefffca04
Clayton,6f8fa19d3dbbd2fb3b768f26d072ac1989d9e3c1bfa6ce8ef961ad845596dcf1,6518,557,10975,13,18063,Clayton6f8fa19d3dbbd2fb3b768f26d072ac1989d9e3c1bfa6ce8ef961ad845596dcf1
Clayton,f1277d1345538b1c42a6abfd8a68340ee6118a6a388884a9b392043b841d6225,4027,343,8165,9,12544,Claytonf1277d1345538b1c42a6abfd8a68340ee6118a6a388884a9b392043b841d6225
Henry,f1277d1345538b1c42a6abfd8a68340ee6118a6a388884a9b392043b841d6225,1512,212,5464,2,7190,Henryf1277d1345538b1c42a6abfd8a68340ee6118a6a388884a9b392043b841d6225
Clayton,279abaa2d2eb6a2f2233464308b9572006684e873f2abbc4568b3f878e53c36f,6405,428,9000,15,15848,Clayton279abaa2d2eb6a2f2233464308b9572006684e873f2abbc4568b3f878e53c36f
Clayton,042f9b0fa0bdcff8fb823dd93ac751a6b368f186851020c3213376eb724e86d2,4292,467,9561,25,14345,Clayton042f9b0fa0bdcff8fb823dd93ac751a6b368f186851020c3213376eb724e86d2
Henry,042f9b0fa0bdcff8fb823dd93ac751a6b368f186851020c3213376eb724e86d2,1444,142,3355,8,4949,Henry042f9b0fa0bdcff8fb823dd93ac751a6b368f186851020c3213376eb724e86d2
DeKalb,a32fc9cbbce8c2c2510a73de6fbbc2876cd92ef34c83a4cc7c09312554d53e92,7726,1274,9100,8,18108,DeKalba32fc9cbbce8c2c2510a73de6fbbc2876cd92ef34c83a4cc7c09312554d53e92
DeKalb,f4ed95fb485640b2683297c30fbc22afadf1fdd5128128fcf399f8b43c9fffd7,4040,553,4261,6,8860,DeKalbf4ed95fb485640b2683297c30fbc22afadf1fdd5128128fcf399f8b43c9fffd7
Fulton,f4ed95fb485640b2683297c30fbc22afadf1fdd5128128fcf399f8b43c9fffd7,1249,275,2001,1,3526,Fultonf4ed95fb485640b2683297c30fbc22afadf1fdd5128128fcf399f8b43c9fffd7
DeKalb,046204667cd46420649f6e551eecf19a7f78e9392dbf35e7c58193927df39ed0,3368,629,4986,10,8993,DeKalb046204667cd46420649f6e551eecf19a7f78e9392dbf35e7c58193927df39ed0
Fulton,046204667cd46420649f6e551eecf19a7f78e9392dbf35e7c58193927df39ed0,894,224,1988,1,3107,Fulton046204667cd46420649f6e551eecf19a7f78e9392dbf35e7c58193927df39ed0
DeKalb,99ac74d4d397a0dd4bcfe3cc0d6b5ab4df6f11ed4c60459645d210a7331c166f,2836,415,3359,0,6610,DeKalb99ac74d4d397a0dd4bcfe3cc0d6b5ab4df6f11ed4c60459645d210a7331c166f
Gwinnett,99ac74d4d397a0dd4bcfe3cc0d6b5ab4df6f11ed4c60459645d210a7331c166f,165,21,116,0,302,Gwinnett99ac74d4d397a0dd4bcfe3cc0d6b5ab4df6f11ed4c60459645d210a7331c166f
DeKalb,c2b41ae1d9fd77ea0b212435361a9ffdd17c54f3e1b276c493fc1784c819821e,3467,482,5286,7,9242,DeKalbc2b41ae1d9fd77ea0b212435361a9ffdd17c54f3e1b276c493fc1784c819821e
Gwinnett,c2b41ae1d9fd77ea0b212435361a9ffdd17c54f3e1b276c493fc1784c819821e,370,34,275,0,679,Gwinnettc2b41ae1d9fd77ea0b212435361a9ffdd17c54f3e1b276c493fc1784c819821e
DeKalb,96c46de81c4123ca28dee9ec15136a03509fd0cfd39cfead8c36afeaa2715c03,8084,1112,8974,15,18185,DeKalb96c46de81c4123ca28dee9ec15136a03509fd0cfd39cfead8c36afeaa2715c03
DeKalb,b5637af3472b2eee5aeebb5d1b646c60112ed85327247ace4d481765d85aba05,9058,1138,13917,9,24122,DeKalbb5637af3472b2eee5aeebb5d1b646c60112ed85327247ace4d481765d85aba05
DeKalb,9ef879f90494307b8b6bcb7388e480349303605a1f82030c8d322109ae80c44e,9061,1278,14932,16,25287,DeKalb9ef879f90494307b8b6bcb7388e480349303605a1f82030c8d322109ae80c44e
DeKalb,d29b293986b293410ab2440b1c95bbe8b5a0f9c6e75ab0d390facfd4e6bfce4a,7219,747,9944,17,17927,DeKalbd29b293986b293410ab2440b1c95bbe8b5a0f9c6e75ab0d390facfd4e6bfce4a
DeKalb,2a3446e31dc48f64cfd885e926fa4ceb526ae8e5884087998096a93f6e510b18,7494,827,10795,8,19124,DeKalb2a3446e31dc48f64cfd885e926fa4ceb526ae8e5884087998096a93f6e510b18
DeKalb,dea30ea7be33d59fc48f21c7ab60f29b1e098544eb6b101216fa5b86040b47f9,7726,740,13110,19,21595,DeKalbdea30ea7be33d59fc48f21c7ab60f29b1e098544eb6b101216fa5b86040b47f9
DeKalb,aba120547dc2a4e959b6e73cb8d3f1b2cae1928005017ef3d162a475d5069498,6576,894,11522,11,19003,DeKalbaba120547dc2a4e959b6e73cb8d3f1b2cae1928005017ef3d162a475d5069498
DeKalb,1a123873efe754481812d1e6b8164e44d853306fcf1800af8a33d305558a0ff1,9985,1048,14986,20,26039,DeKalb1a123873efe754481812d1e6b8164e44d853306fcf1800af8a33d305558a0ff1
DeKalb,fffa525bce63bda49aec05b4bec550be2a7bfb01893789efd36f7e8ff85b4454,4631,527,9901,6,15065,DeKalbfffa525bce63bda49aec05b4bec550be2a7bfb01893789efd36f7e8ff85b4454
Henry,fffa525bce63bda49aec05b4bec550be2a7bfb01893789efd36f7e8ff85b4454,1536,170,4265,3,5974,Henryfffa525bce63bda49aec05b4bec550be2a7bfb01893789efd36f7e8ff85b4454
Rockdale,fffa525bce63bda49aec05b4bec550be2a7bfb01893789efd36f7e8ff85b4454,567,57,1261,0,1885,Rockdalefffa525bce63bda49aec05b4bec550be2a7bfb01893789efd36f7e8ff85b4454
DeKalb,b61f9866995154f394e942c15e1c2235ef98c0e2834c9e62fb1325c0eaae9e2d,181,39,365,0,585,DeKalbb61f9866995154f394e942c15e1c2235ef98c0e2834c9e62fb1325c0eaae9e2d
Rockdale,b61f9866995154f394e942c15e1c2235ef98c0e2834c9e62fb1325c0eaae9e2d,1383,321,4679,5,6388,Rockdaleb61f9866995154f394e942c15e1c2235ef98c0e2834c9e62fb1325c0eaae9e2d
DeKalb,79882862b913ba38b1de8d7594176b9903ef253169a46c3dfb6b294932c6001b,2848,276,5373,2,8499,DeKalb79882862b913ba38b1de8d7594176b9903ef253169a46c3dfb6b294932c6001b
Rockdale,79882862b913ba38b1de8d7594176b9903ef253169a46c3dfb6b294932c6001b,2329,319,7004,10,9662,Rockdale79882862b913ba38b1de8d7594176b9903ef253169a46c3dfb6b294932c6001b
DeKalb,6e051cdaf0d5f111292634aaba7fad7c6b616079ce62f9f0288ae5b60eb21ee3,3259,303,5257,4,8823,DeKalb6e051cdaf0d5f111292634aaba7fad7c6b616079ce62f9f0288ae5b60eb21ee3
Rockdale,6e051cdaf0d5f111292634aaba7fad7c6b616079ce62f9f0288ae5b60eb21ee3,2496,285,4879,3,7663,Rockdale6e051cdaf0d5f111292634aaba7fad7c6b616079ce62f9f0288ae5b60eb21ee3
DeKalb,d142738051db6c6a4be74fcc58c94d8aa7e83dfd358b53b1f28c962ae2668e0b,2599,235,4745,3,7582,DeKalbd142738051db6c6a4be74fcc58c94d8aa7e83dfd358b53b1f28c962ae2668e0b
Gwinnett,d142738051db6c6a4be74fcc58c94d8aa7e83dfd358b53b1f28c962ae2668e0b,5786,571,8779,23,15159,Gwinnettd142738051db6c6a4be74fcc58c94d8aa7e83dfd358b53b1f28c962ae2668e0b
DeKalb,ab9aea75da1d510e3b5ac41c75650c6eb164a5487d9665da863aa30eb0acefdf,4237,370,8276,6,12889,DeKalbab9aea75da1d510e3b5ac41c75650c6eb164a5487d9665da863aa30eb0acefdf
Gwinnett,ab9aea75da1d510e3b5ac41c75650c6eb164a5487d9665da863aa30eb0acefdf,3795,387,4315,13,8510,Gwinnettab9aea75da1d510e3b5ac41c75650c6eb164a5487d9665da863aa30eb0acefdf
Fulton,c9ba1a0092557a465302aa389634dc38ac3c8f8b43ab933c92aa736120a8080d,300,96,914,0,1310,Fultonc9ba1a0092557a465302aa389634dc38ac3c8f8b43ab933c92aa736120a8080d
Gwinnett,c9ba1a0092557a465302aa389634dc38ac3c8f8b43ab933c92aa736120a8080d,10382,1430,5125,46,16983,Gwinnettc9ba1a0092557a465302aa389634dc38ac3c8f8b43ab933c92aa736120a8080d
Gwinnett,7956abe5832a2ef20012d703c5207f2ce410caf2fe07832c42ea5e3a657c666a,2865,440,1970,6,5281,Gwinnett7956abe5832a2ef20012d703c5207f2ce410caf2fe07832c42ea5e3a657c666a
Gwinnett,aa13f86c693db6b660c74f55bdd9b8e69db13b677f1e4315e36c5836187dbfac,4660,290,3655,21,8626,Gwinnettaa13f86c693db6b660c74f55bdd9b8e69db13b677f1e4315e36c5836187dbfac
Gwinnett,cae2dec2a1c10e5f501b960aaf9cfbd43b332ca462a6c11ab2d8724d5e8bf5e9,9999,1378,8741,53,20171,Gwinnettcae2dec2a1c10e5f501b960aaf9cfbd43b332ca462a6c11ab2d8724d5e8bf5e9
Gwinnett,8d0b813d97ce3d7007a70d7e47889ffdec74cc2f07e19fab417955818953c888,9843,1043,8501,76,19463,Gwinnett8d0b813d97ce3d7007a70d7e47889ffdec74cc2f07e19fab417955818953c888
Gwinnett,b1884dc7eea472f0242efb0e3fbc4c9ce2df1ae700e7c76209e17b88e7c84d43,4260,279,3519,10,8068,Gwinnettb1884dc7eea472f0242efb0e3fbc4c9ce2df1ae700e7c76209e17b88e7c84d43
Gwinnett,edcf2b010d117cc52b20d71c9a68fcffac974af9ce4f12b471f33829d70dc30f,6373,456,4318,33,11180,Gwinnettedcf2b010d117cc52b20d71c9a68fcffac974af9ce4f12b471f33829d70dc30f
Gwinnett,92ea1b954e15fc04ef9324262e2ba22f0eb6ce6cda4021fe2b573a915cf312a9,5429,814,3960,8,10211,Gwinnett92ea1b954e15fc04ef9324262e2ba22f0eb6ce6cda4021fe2b573a915cf312a9
Gwinnett,35ad676243c8c36ecaf440f0fb0b9a33da93b56f9a5a2fd11c426b86c88df23c,5345,462,4841,23,10671,Gwinnett35ad676243c8c36ecaf440f0fb0b9a33da93b56f9a5a2fd11c426b86c88df23c
Gwinnett,7d570eac554cd5a060dcd1b293117a56689d33976cca0066ca47773600ec2dce,6180,743,5196,5,12124,Gwinnett7d570eac554cd5a060dcd1b293117a56689d33976cca0066ca47773600ec2dce
Gwinnett,61b66786c2fc3bb8eac7c9d017a5537f6b530cbd30f6deefbae4a73d56aee718,4590,429,4526,22,9567,Gwinnett61b66786c2fc3bb8eac7c9d017a5537f6b530cbd30f6deefbae4a73d56aee718
Gwinnett,d13619a98490510857fa916f15c5b0d77bfd01a0375fdb965b868f17248e2296,6288,730,5945,6,12969,Gwinnettd13619a98490510857fa916f15c5b0d77bfd01a0375fdb965b868f17248e2296
Hall,d13619a98490510857fa916f15c5b0d77bfd01a0375fdb965b868f17248e2296,4893,578,5314,1,10786,Halld13619a98490510857fa916f15c5b0d77bfd01a0375fdb965b868f17248e2296
Gwinnett,2e7d02815511d7c1f30bf6f8859b27feb40b489f1d102ab69310c44bb9134ca4,8956,940,9865,15,19776,Gwinnett2e7d02815511d7c1f30bf6f8859b27feb40b489f1d102ab69310c44bb9134ca4
Gwinnett,611049554e3390ed89b8c538914e7a304cee3d73c306b8b421806b774b71e6a9,6158,704,5541,8,12411,Gwinnett611049554e3390ed89b8c538914e7a304cee3d73c306b8b421806b774b71e6a9
Gwinnett,51211a0e0c0f744cefcbab798c45abd8c088ff2cc3e33d5e5844478efe48e491,4931,432,6813,13,12189,Gwinnett51211a0e0c0f744cefcbab798c45abd8c088ff2cc3e33d5e5844478efe48e491
Gwinnett,589a0a5eb53d1728924505fe01de2ef2de00e05194a88c43822dc49af82ba1c4,8490,1242,8083,20,17835,Gwinnett589a0a5eb53d1728924505fe01de2ef2de00e05194a88c43822dc49af82ba1c4
Gwinnett,1ad26a38a3818e6a6753796971d1c53b41ef493e47936c76b8ba52fea8c021be,8411,932,6501,17,15861,Gwinnett1ad26a38a3818e6a6753796971d1c53b41ef493e47936c76b8ba52fea8c021be
Gwinnett,7fcf7919d1730e1deab6373246ec83c88f7527c94c252fef5ffc8e494e44be20,5323,982,5379,20,11704,Gwinnett7fcf7919d1730e1deab6373246ec83c88f7527c94c252fef5ffc8e494e44be20
Gwinnett,ade24beef83a54d95b43965b4743396f4427301c43a308b67030dadf952d02ac,4557,489,5447,31,10524,Gwinnettade24beef83a54d95b43965b4743396f4427301c43a308b67030dadf952d02ac
Henry,500aba4133497925203f32fcbefe93feba3506ee9f9251126a7f17895206598c,3764,508,8436,3,12711,Henry500aba4133497925203f32fcbefe93feba3506ee9f9251126a7f17895206598c
Newton,500aba4133497925203f32fcbefe93feba3506ee9f9251126a7f17895206598c,348,30,455,0,833,Newton500aba4133497925203f32fcbefe93feba3506ee9f9251126a7f17895206598c
Rockdale,500aba4133497925203f32fcbefe93feba3506ee9f9251126a7f17895206598c,572,58,1333,0,1963,Rockdale500aba4133497925203f32fcbefe93feba3506ee9f9251126a7f17895206598c
Henry,33bd0563668ba9d0f22dc7bebc9f9f8fb5e35d343933b2810ece128cb52ebbac,2447,281,6077,3,8808,Henry33bd0563668ba9d0f22dc7bebc9f9f8fb5e35d343933b2810ece128cb52ebbac
Newton,33bd0563668ba9d0f22dc7bebc9f9f8fb5e35d343933b2810ece128cb52ebbac,279,17,429,0,725,Newton33bd0563668ba9d0f22dc7bebc9f9f8fb5e35d343933b2810ece128cb52ebbac
Rockdale,33bd0563668ba9d0f22dc7bebc9f9f8fb5e35d343933b2810ece128cb52ebbac,494,57,1305,0,1856,Rockdale33bd0563668ba9d0f22dc7bebc9f9f8fb5e35d343933b2810ece128cb52ebbac
Butts,8c65c1b7e3c0564379f46f82951d511a02b20141a834456895271f8c1b9e9461,1279,102,2758,0,4139,Butts8c65c1b7e3c0564379f46f82951d511a02b20141a834456895271f8c1b9e9461
Henry,8c65c1b7e3c0564379f46f82951d511a02b20141a834456895271f8c1b9e9461,3072,320,6460,3,9855,Henry8c65c1b7e3c0564379f46f82951d511a02b20141a834456895271f8c1b9e9461
Newton,8c65c1b7e3c0564379f46f82951d511a02b20141a834456895271f8c1b9e9461,1849,158,2002,0,4009,Newton8c65c1b7e3c0564379f46f82951d511a02b20141a834456895271f8c1b9e9461
Henry,51707b4b858310eb9cbec8366c44f571ccd5d362303e0de8469e6b5bb237096d,3607,591,10285,5,14488,Henry51707b4b858310eb9cbec8366c44f571ccd5d362303e0de8469e6b5bb237096d
Henry,fcd22cf6254b15bd5eca44a8be86fd7e38f465a74a7dd26cbc3bed38bf356993,3882,418,9234,8,13542,Henryfcd22cf6254b15bd5eca44a8be86fd7e38f465a74a7dd26cbc3bed38bf356993
Morgan,5286eb2ed1a9b1f495e89b7d9a186b42390144a26334210bd546f0ea4ba91aa6,2979,308,4573,4,7864,Morgan5286eb2ed1a9b1f495e89b7d9a186b42390144a26334210bd546f0ea4ba91aa6
Newton,5286eb2ed1a9b1f495e89b7d9a186b42390144a26334210bd546f0ea4ba91aa6,7470,690,5693,1,13854,Newton5286eb2ed1a9b1f495e89b7d9a186b42390144a26334210bd546f0ea4ba91aa6
Newton,c316a4334b7e3e560e6fac089b0a561548a7369d1bd82e5fc8623fee8c0ced83,6871,736,9022,0,16629,Newtonc316a4334b7e3e560e6fac089b0a561548a7369d1bd82e5fc8623fee8c0ced83
Rockdale,c316a4334b7e3e560e6fac089b0a561548a7369d1bd82e5fc8623fee8c0ced83,619,69,1517,0,2205,Rockdalec316a4334b7e3e560e6fac089b0a561548a7369d1bd82e5fc8623fee8c0ced83
Barrow,b6d765520021fd08cd8fbf59839157c9b48611e0793a65e7984df5899742625c,1739,125,1851,0,3715,Barrowb6d765520021fd08cd8fbf59839157c9b48611e0793a65e7984df5899742625c
Gwinnett,b6d765520021fd08cd8fbf59839157c9b48611e0793a65e7984df5899742625c,1338,149,1314,1,2802,Gwinnettb6d765520021fd08cd8fbf59839157c9b48611e0793a65e7984df5899742625c
Rockdale,b6d765520021fd08cd8fbf59839157c9b48611e0793a65e7984df5899742625c,663,67,1051,1,1782,Rockdaleb6d765520021fd08cd8fbf59839157c9b48611e0793a65e7984df5899742625c
Walton,b6d765520021fd08cd8fbf59839157c9b48611e0793a65e7984df5899742625c,7124,650,6112,1,13887,Waltonb6d765520021fd08cd8fbf59839157c9b48611e0793a65e7984df5899742625c
Walton,9b1f46f3449e0dc0713faaad54fa5c1d059743648b1f4e5fc876810684f6123d,10797,742,9076,29,20644,Walton9b1f46f3449e0dc0713faaad54fa5c1d059743648b1f4e5fc876810684f6123d
Barrow,081539fe444fbcddcb5c9407b53e184b5a4c5239c2a10daa49943f6ef8760327,8229,760,10154,1,19144,Barrow081539fe444fbcddcb5c9407b53e184b5a4c5239c2a10daa49943f6ef8760327
Barrow,8b9792a93880fe90290009bd57e2ce595abd725e0979c6cbf5bad2b97d17e40e,837,51,991,0,1879,Barrow8b9792a93880fe90290009bd57e2ce595abd725e0979c6cbf5bad2b97d17e40e
Clarke,8b9792a93880fe90290009bd57e2ce595abd725e0979c6cbf5bad2b97d17e40e,3796,637,4475,9,8917,Clarke8b9792a93880fe90290009bd57e2ce595abd725e0979c6cbf5bad2b97d17e40e
Jackson,8b9792a93880fe90290009bd57e2ce595abd725e0979c6cbf5bad2b97d17e40e,1266,80,981,1,2328,Jackson8b9792a93880fe90290009bd57e2ce595abd725e0979c6cbf5bad2b97d17e40e
Oconee,8b9792a93880fe90290009bd57e2ce595abd725e0979c6cbf5bad2b97d17e40e,1883,268,3097,2,5250,Oconee8b9792a93880fe90290009bd57e2ce595abd725e0979c6cbf5bad2b97d17e40e
Clarke,9140fe123e6a64a6735a1b43e9fd76f233bf50bba61422001d0d16ee6d01479f,7037,824,8344,18,16223,Clarke9140fe123e6a64a6735a1b43e9fd76f233bf50bba61422001d0d16ee6d01479f
Clarke,da2409475629779b2cceefc4363122da9e0e88f8e4b20cb1b8bbfbbcb8601caa,3442,391,3678,13,7524,Clarkeda2409475629779b2cceefc4363122da9e0e88f8e4b20cb1b8bbfbbcb8601caa
Oconee,da2409475629779b2cceefc4363122da9e0e88f8e4b20cb1b8bbfbbcb8601caa,4641,393,6493,4,11531,Oconeeda2409475629779b2cceefc4363122da9e0e88f8e4b20cb1b8bbfbbcb8601caa
Greene,228de7152ccbca20d812e520fd3071bb12c7f2a26312bc4ab9ba19119bfcc0e8,2132,448,4787,7,7374,Greene228de7152ccbca20d812e520fd3071bb12c7f2a26312bc4ab9ba19119bfcc0e8
Oglethorpe,228de7152ccbca20d812e520fd3071bb12c7f2a26312bc4ab9ba19119bfcc0e8,1873,291,3123,2,5289,Oglethorpe228de7152ccbca20d812e520fd3071bb12c7f2a26312bc4ab9ba19119bfcc0e8
Putnam,228de7152ccbca20d812e520fd3071bb12c7f2a26312bc4ab9ba19119bfcc0e8,1852,312,2898,3,5065,Putnam228de7152ccbca20d812e520fd3071bb12c7f2a26312bc4ab9ba19119bfcc0e8
Taliaferro,228de7152ccbca20d812e520fd3071bb12c7f2a26312bc4ab9ba19119bfcc0e8,226,43,235,1,505,Taliaferro228de7152ccbca20d812e520fd3071bb12c7f2a26312bc4ab9ba19119bfcc0e8
Wilkes,228de7152ccbca20d812e520fd3071bb12c7f2a26312bc4ab9ba19119bfcc0e8,1012,96,1006,3,2117,Wilkes228de7152ccbca20d812e520fd3071bb12c7f2a26312bc4ab9ba19119bfcc0e8
Columbia,9a4b660978fab41a62462d1bda3aff0859c9fda3dc3db17a96d9f00244d252b8,7524,585,6690,5,14804,Columbia9a4b660978fab41a62462d1bda3aff0859c9fda3dc3db17a96d9f00244d252b8
McDuffie,9a4b660978fab41a62462d1bda3aff0859c9fda3dc3db17a96d9f00244d252b8,2184,311,3283,0,5778,McDuffie9a4b660978fab41a62462d1bda3aff0859c9fda3dc3db17a96d9f00244d252b8
Columbia,3df2b26f2789f3d762303e0ed65fe41663adf663d627846214536662c859bb96,9073,1283,16547,11,26914,Columbia3df2b26f2789f3d762303e0ed65fe41663adf663d627846214536662c859bb96
Columbia,31a93ee56ecd0b50e2a35db7dde4e5a6527ac9ea11a2460f001c671d8746e20f,5463,635,6390,2,12490,Columbia31a93ee56ecd0b50e2a35db7dde4e5a6527ac9ea11a2460f001c671d8746e20f
Richmond,31a93ee56ecd0b50e2a35db7dde4e5a6527ac9ea11a2460f001c671d8746e20f,3949,571,4604,5,9129,Richmond31a93ee56ecd0b50e2a35db7dde4e5a6527ac9ea11a2460f001c671d8746e20f
Richmond,73fea0ba927c21fbacba3d4a00a7583e98a4a7cafb14a2e33bf357903d49d3a7,7898,962,5876,15,14751,Richmond73fea0ba927c21fbacba3d4a00a7583e98a4a7cafb14a2e33bf357903d49d3a7
Richmond,38b5b2b9fa4863da50d01961854745f8c23bb57a04a8a013d3e6b97ec9a5a873,7650,853,6609,8,15120,Richmond38b5b2b9fa4863da50d01961854745f8c23bb57a04a8a013d3e6b97ec9a5a873
Burke,36d07719b01c9fa5f1e8021805417a751403c51c64fec60fbbeb17ae0be282f7,3555,809,2625,0,6989,Burke36d07719b01c9fa5f1e8021805417a751403c51c64fec60fbbeb17ae0be282f7
Richmond,36d07719b01c9fa5f1e8021805417a751403c51c64fec60fbbeb17ae0be282f7,4633,534,6885,10,12062,Richmond36d07719b01c9fa5f1e8021805417a751403c51c64fec60fbbeb17ae0be282f7
Jefferson,2fe73a3073a681ff929eb26aadd85febb87438c7ecc0c1051d6e8a7fcc7652c2,1977,254,1723,9,3963,Jefferson2fe73a3073a681ff929eb26aadd85febb87438c7ecc0c1051d6e8a7fcc7652c2
Richmond,2fe73a3073a681ff929eb26aadd85febb87438c7ecc0c1051d6e8a7fcc7652c2,4665,653,5963,7,11288,Richmond2fe73a3073a681ff929eb26aadd85febb87438c7ecc0c1051d6e8a7fcc7652c2
Glascock,36af3b560fd41569726b382ddc21bb0e3a63bca246ef224b43819c3bff0d0274,388,40,409,0,837,Glascock36af3b560fd41569726b382ddc21bb0e3a63bca246ef224b43819c3bff0d0274
Hancock,36af3b560fd41569726b382ddc21bb0e3a63bca246ef224b43819c3bff0d0274,1344,263,1014,7,2628,Hancock36af3b560fd41569726b382ddc21bb0e3a63bca246ef224b43819c3bff0d0274
Jefferson,36af3b560fd41569726b382ddc21bb0e3a63bca246ef224b43819c3bff0d0274,636,150,363,4,1153,Jefferson36af3b560fd41569726b382ddc21bb0e3a63bca246ef224b43819c3bff0d0274
Johnson,36af3b560fd41569726b382ddc21bb0e3a63bca246ef224b43819c3bff0d0274,442,110,714,0,1266,Johnson36af3b560fd41569726b382ddc21bb0e3a63bca246ef224b43819c3bff0d0274
McDuffie,36af3b560fd41569726b382ddc21bb0e3a63bca246ef224b43819c3bff0d0274,513,134,804,0,1451,McDuffie36af3b560fd41569726b382ddc21bb0e3a63bca246ef224b43819c3bff0d0274
Warren,36af3b560fd41569726b382ddc21bb0e3a63bca246ef224b43819c3bff0d0274,720,100,832,1,1653,Warren36af3b560fd41569726b382ddc21bb0e3a63bca246ef224b43819c3bff0d0274
Washington,36af3b560fd41569726b382ddc21bb0e3a63bca246ef224b43819c3bff0d0274,2907,597,3236,19,6759,Washington36af3b560fd41569726b382ddc21bb0e3a63bca246ef224b43819c3bff0d0274
Butts,92d3978b6a2cde9355edf97a92363a77bc67ac7fb091725bf7cc3b8fef1da52a,901,122,2657,0,3680,Butts92d3978b6a2cde9355edf97a92363a77bc67ac7fb091725bf7cc3b8fef1da52a
Jasper,92d3978b6a2cde9355edf97a92363a77bc67ac7fb091725bf7cc3b8fef1da52a,2000,280,2838,6,5124,Jasper92d3978b6a2cde9355edf97a92363a77bc67ac7fb091725bf7cc3b8fef1da52a
Jones,92d3978b6a2cde9355edf97a92363a77bc67ac7fb091725bf7cc3b8fef1da52a,2726,435,4534,1,7696,Jones92d3978b6a2cde9355edf97a92363a77bc67ac7fb091725bf7cc3b8fef1da52a
Monroe,92d3978b6a2cde9355edf97a92363a77bc67ac7fb091725bf7cc3b8fef1da52a,939,39,727,1,1706,Monroe92d3978b6a2cde9355edf97a92363a77bc67ac7fb091725bf7cc3b8fef1da52a
Henry,0a9d600c307bda5e3538ea95d6384d842fe3bc40c30f7ead61e2552a32a1d3b5,513,79,1615,1,2208,Henry0a9d600c307bda5e3538ea95d6384d842fe3bc40c30f7ead61e2552a32a1d3b5
Lamar,0a9d600c307bda5e3538ea95d6384d842fe3bc40c30f7ead61e2552a32a1d3b5,1412,146,1856,7,3421,Lamar0a9d600c307bda5e3538ea95d6384d842fe3bc40c30f7ead61e2552a32a1d3b5
Spalding,0a9d600c307bda5e3538ea95d6384d842fe3bc40c30f7ead61e2552a32a1d3b5,3730,463,6827,6,11026,Spalding0a9d600c307bda5e3538ea95d6384d842fe3bc40c30f7ead61e2552a32a1d3b5
Lamar,716840e9b1c3e922fa80301416248ddf337ca4ca0f008e233c9c4d304f8b8186,994,115,1510,3,2622,Lamar716840e9b1c3e922fa80301416248ddf337ca4ca0f008e233c9c4d304f8b8186
Pike,716840e9b1c3e922fa80301416248ddf337ca4ca0f008e233c9c4d304f8b8186,2828,301,4429,4,7562,Pike716840e9b1c3e922fa80301416248ddf337ca4ca0f008e233c9c4d304f8b8186
Upson,716840e9b1c3e922fa80301416248ddf337ca4ca0f008e233c9c4d304f8b8186,2352,353,5819,4,8528,Upson716840e9b1c3e922fa80301416248ddf337ca4ca0f008e233c9c4d304f8b8186
Coweta,a289dda361535d100884b72a41f19c7c5a0e699a299d7df5df790f212d4404d7,1665,91,1136,3,2895,Cowetaa289dda361535d100884b72a41f19c7c5a0e699a299d7df5df790f212d4404d7
Meriwether,a289dda361535d100884b72a41f19c7c5a0e699a299d7df5df790f212d4404d7,750,44,626,2,1422,Meriwethera289dda361535d100884b72a41f19c7c5a0e699a299d7df5df790f212d4404d7
Troup,a289dda361535d100884b72a41f19c7c5a0e699a299d7df5df790f212d4404d7,1833,202,2015,35,4085,Troupa289dda361535d100884b72a41f19c7c5a0e699a299d7df5df790f212d4404d7
Coweta,8d922f7a054c87ea052330c3c048cb4a16ee5fe0bfbc039356cb1f6e96c01371,1379,115,872,2,2368,Coweta8d922f7a054c87ea052330c3c048cb4a16ee5fe0bfbc039356cb1f6e96c01371
Meriwether,8d922f7a054c87ea052330c3c048cb4a16ee5fe0bfbc039356cb1f6e96c01371,1023,82,690,3,1798,Meriwether8d922f7a054c87ea052330c3c048cb4a16ee5fe0bfbc039356cb1f6e96c01371
Troup,8d922f7a054c87ea052330c3c048cb4a16ee5fe0bfbc039356cb1f6e96c01371,2774,279,2482,49,5584,Troup8d922f7a054c87ea052330c3c048cb4a16ee5fe0bfbc039356cb1f6e96c01371
Harris,68296005252c18866d7d9957186cb5d883aea78b0f13c17f265b13037f2755bb,3501,330,4284,1,8116,Harris68296005252c18866d7d9957186cb5d883aea78b0f13c17f265b13037f2755bb
Muscogee,68296005252c18866d7d9957186cb5d883aea78b0f13c17f265b13037f2755bb,2439,322,2649,0,5410,Muscogee68296005252c18866d7d9957186cb5d883aea78b0f13c17f265b13037f2755bb
Troup,68296005252c18866d7d9957186cb5d883aea78b0f13c17f265b13037f2755bb,3776,415,3898,73,8162,Troup68296005252c18866d7d9957186cb5d883aea78b0f13c17f265b13037f2755bb
Harris,55fcf092f0152e8529a91cdf17b91b8e062ca7b72e895b2446413268cac90588,1633,159,2289,0,4081,Harris55fcf092f0152e8529a91cdf17b91b8e062ca7b72e895b2446413268cac90588
Muscogee,55fcf092f0152e8529a91cdf17b91b8e062ca7b72e895b2446413268cac90588,7607,905,6843,9,15364,Muscogee55fcf092f0152e8529a91cdf17b91b8e062ca7b72e895b2446413268cac90588
Muscogee,bb5d58d0199619fde460e8a0a68e9296da23a0ea16a2fd613b98deea558a8c13,5541,603,4825,22,10991,Muscogeebb5d58d0199619fde460e8a0a68e9296da23a0ea16a2fd613b98deea558a8c13
Muscogee,61b0e921d030c4fe520c9a702154e53e4d54900308e2f47fccd034876d6d4c30,7111,910,8621,20,16662,Muscogee61b0e921d030c4fe520c9a702154e53e4d54900308e2f47fccd034876d6d4c30
Harris,5acb963d6c63d557a260f4cfb03d7dc7c83dd373f32ca44e2741723c9aeb9cce,800,91,767,0,1658,Harris5acb963d6c63d557a260f4cfb03d7dc7c83dd373f32ca44e2741723c9aeb9cce
Meriwether,5acb963d6c63d557a260f4cfb03d7dc7c83dd373f32ca44e2741723c9aeb9cce,2827,230,1646,0,4703,Meriwether5acb963d6c63d557a260f4cfb03d7dc7c83dd373f32ca44e2741723c9aeb9cce
Muscogee,5acb963d6c63d557a260f4cfb03d7dc7c83dd373f32ca44e2741723c9aeb9cce,3853,456,5724,9,10042,Muscogee5acb963d6c63d557a260f4cfb03d7dc7c83dd373f32ca44e2741723c9aeb9cce
Talbot,5acb963d6c63d557a260f4cfb03d7dc7c83dd373f32ca44e2741723c9aeb9cce,1511,499,663,0,2673,Talbot5acb963d6c63d557a260f4cfb03d7dc7c83dd373f32ca44e2741723c9aeb9cce
Chattahoochee,2fd94aba423567a3e278321b0161790f14569a56f83a09aebdc415b10f809abf,373,25,257,5,660,Chattahoochee2fd94aba423567a3e278321b0161790f14569a56f83a09aebdc415b10f809abf
Marion,2fd94aba423567a3e278321b0161790f14569a56f83a09aebdc415b10f809abf,1066,87,751,0,1904,Marion2fd94aba423567a3e278321b0161790f14569a56f83a09aebdc415b10f809abf
Schley,2fd94aba423567a3e278321b0161790f14569a56f83a09aebdc415b10f809abf,392,42,866,0,1300,Schley2fd94aba423567a3e278321b0161790f14569a56f83a09aebdc415b10f809abf
Sumter,2fd94aba423567a3e278321b0161790f14569a56f83a09aebdc415b10f809abf,1623,204,1969,1,3797,Sumter2fd94aba423567a3e278321b0161790f14569a56f83a09aebdc415b10f809abf
Chattahoochee,155d0966342a331f1076d65194837df8b37d02dfc464a446e30873855b628182,303,19,289,1,612,Chattahoochee155d0966342a331f1076d65194837df8b37d02dfc464a446e30873855b628182
Marion,155d0966342a331f1076d65194837df8b37d02dfc464a446e30873855b628182,497,168,504,0,1169,Marion155d0966342a331f1076d65194837df8b37d02dfc464a446e30873855b628182
Schley,155d0966342a331f1076d65194837df8b37d02dfc464a446e30873855b628182,189,43,348,0,580,Schley155d0966342a331f1076d65194837df8b37d02dfc464a446e30873855b628182
Sumter,155d0966342a331f1076d65194837df8b37d02dfc464a446e30873855b628182,2095,441,3020,0,5556,Sumter155d0966342a331f1076d65194837df8b37d02dfc464a446e30873855b628182
Dooly,a6bd7d5e9dd08d7b58965f944a71bc6209f8a2b12dc949e5daa400ccc782bcb6,1421,134,1314,16,2885,Doolya6bd7d5e9dd08d7b58965f944a71bc6209f8a2b12dc949e5daa400ccc782bcb6
Macon,a6bd7d5e9dd08d7b58965f944a71bc6209f8a2b12dc949e5daa400ccc782bcb6,1465,198,1673,0,3336,Macona6bd7d5e9dd08d7b58965f944a71bc6209f8a2b12dc949e5daa400ccc782bcb6
Peach,a6bd7d5e9dd08d7b58965f944a71bc6209f8a2b12dc949e5daa400ccc782bcb6,1315,179,2530,10,4034,Peacha6bd7d5e9dd08d7b58965f944a71bc6209f8a2b12dc949e5daa400ccc782bcb6
Taylor,a6bd7d5e9dd08d7b58965f944a71bc6209f8a2b12dc949e5daa400ccc782bcb6,1089,228,1308,0,2625,Taylora6bd7d5e9dd08d7b58965f944a71bc6209f8a2b12dc949e5daa400ccc782bcb6
Bibb,1f75e92e6610a18594ddbf341149413fb745bad627a2fd61a7c997e332730232,812,46,470,1,1329,Bibb1f75e92e6610a18594ddbf341149413fb745bad627a2fd61a7c997e332730232
Crawford,1f75e92e6610a18594ddbf341149413fb745bad627a2fd61a7c997e332730232,1920,209,2145,4,4278,Crawford1f75e92e6610a18594ddbf341149413fb745bad627a2fd61a7c997e332730232
Houston,1f75e92e6610a18594ddbf341149413fb745bad627a2fd61a7c997e332730232,1444,181,2286,7,3918,Houston1f75e92e6610a18594ddbf341149413fb745bad627a2fd61a7c997e332730232
Monroe,1f75e92e6610a18594ddbf341149413fb745bad627a2fd61a7c997e332730232,879,85,954,0,1918,Monroe1f75e92e6610a18594ddbf341149413fb745bad627a2fd61a7c997e332730232
Peach,1f75e92e6610a18594ddbf341149413fb745bad627a2fd61a7c997e332730232,1488,119,3301,10,4918,Peach1f75e92e6610a18594ddbf341149413fb745bad627a2fd61a7c997e332730232
Bibb,9b274111dee14dabf8115358c5af33ff0f0cdcd1c155521d6f92495becbcd063,8164,984,6732,15,15895,Bibb9b274111dee14dabf8115358c5af33ff0f0cdcd1c155521d6f92495becbcd063
Monroe,9b274111dee14dabf8115358c5af33ff0f0cdcd1c155521d6f92495becbcd063,3056,265,3480,7,6808,Monroe9b274111dee14dabf8115358c5af33ff0f0cdcd1c155521d6f92495becbcd063
Bibb,ce3e8620638c39a651995492889eb6b3e9f89cc08f3f439e8866740313643a46,7137,829,8140,18,16124,Bibbce3e8620638c39a651995492889eb6b3e9f89cc08f3f439e8866740313643a46
Bibb,47197eea5fee5c4cf4bbf2dd31d6860d122860d278a5cebe0b6c221a0f2fa9ca,7381,1105,6995,47,15528,Bibb47197eea5fee5c4cf4bbf2dd31d6860d122860d278a5cebe0b6c221a0f2fa9ca
Bibb,e0be3b97744d48e768f018be2ed01a269f506b92f78857ae8db5cc2b80bf4a9b,823,68,456,0,1347,Bibbe0be3b97744d48e768f018be2ed01a269f506b92f78857ae8db5cc2b80bf4a9b
Bleckley,e0be3b97744d48e768f018be2ed01a269f506b92f78857ae8db5cc2b80bf4a9b,1570,137,2145,2,3854,Bleckleye0be3b97744d48e768f018be2ed01a269f506b92f78857ae8db5cc2b80bf4a9b
Houston,e0be3b97744d48e768f018be2ed01a269f506b92f78857ae8db5cc2b80bf4a9b,824,84,1587,0,2495,Houstone0be3b97744d48e768f018be2ed01a269f506b92f78857ae8db5cc2b80bf4a9b
Jones,e0be3b97744d48e768f018be2ed01a269f506b92f78857ae8db5cc2b80bf4a9b,904,89,1032,0,2025,Jonese0be3b97744d48e768f018be2ed01a269f506b92f78857ae8db5cc2b80bf4a9b
Laurens,e0be3b97744d48e768f018be2ed01a269f506b92f78857ae8db5cc2b80bf4a9b,675,68,398,0,1141,Laurense0be3b97744d48e768f018be2ed01a269f506b92f78857ae8db5cc2b80bf4a9b
Twiggs,e0be3b97744d48e768f018be2ed01a269f506b92f78857ae8db5cc2b80bf4a9b,1172,112,808,1,2093,Twiggse0be3b97744d48e768f018be2ed01a269f506b92f78857ae8db5cc2b80bf4a9b
Wilkinson,e0be3b97744d48e768f018be2ed01a269f506b92f78857ae8db5cc2b80bf4a9b,1483,89,760,1,2333,Wilkinsone0be3b97744d48e768f018be2ed01a269f506b92f78857ae8db5cc2b80bf4a9b
Bibb,0c47f9b9d27e4d5470e49e84b98204dafd21babac2afb277674d98cc2a564855,240,44,341,0,625,Bibb0c47f9b9d27e4d5470e49e84b98204dafd21babac2afb277674d98cc2a564855
Bleckley,0c47f9b9d27e4d5470e49e84b98204dafd21babac2afb277674d98cc2a564855,429,107,442,5,983,Bleckley0c47f9b9d27e4d5470e49e84b98204dafd21babac2afb277674d98cc2a564855
Houston,0c47f9b9d27e4d5470e49e84b98204dafd21babac2afb277674d98cc2a564855,260,34,555,0,849,Houston0c47f9b9d27e4d5470e49e84b98204dafd21babac2afb277674d98cc2a564855
Jones,0c47f9b9d27e4d5470e49e84b98204dafd21babac2afb277674d98cc2a564855,340,38,390,0,768,Jones0c47f9b9d27e4d5470e49e84b98204dafd21babac2afb277674d98cc2a564855
Laurens,0c47f9b9d27e4d5470e49e84b98204dafd21babac2afb277674d98cc2a564855,275,49,175,0,499,Laurens0c47f9b9d27e4d5470e49e84b98204dafd21babac2afb277674d98cc2a564855
Twiggs,0c47f9b9d27e4d5470e49e84b98204dafd21babac2afb277674d98cc2a564855,844,216,701,0,1761,Twiggs0c47f9b9d27e4d5470e49e84b98204dafd21babac2afb277674d98cc2a564855
Wilkinson,0c47f9b9d27e4d5470e49e84b98204dafd21babac2afb277674d98cc2a564855,969,118,731,2,1820,Wilkinson0c47f9b9d27e4d5470e49e84b98204dafd21babac2afb277674d98cc2a564855
Baldwin,54ea80fa12f2fc3955fc86eebd2a7b4dea8568619e263d3434e10c20f173c18d,3219,404,4988,4,8615,Baldwin54ea80fa12f2fc3955fc86eebd2a7b4dea8568619e263d3434e10c20f173c18d
Putnam,54ea80fa12f2fc3955fc86eebd2a7b4dea8568619e263d3434e10c20f173c18d,828,120,1271,0,2219,Putnam54ea80fa12f2fc3955fc86eebd2a7b4dea8568619e263d3434e10c20f173c18d
Baldwin,ee7303e7b8f3d839fa7ea29f0cdfcd9bc68d0d1efb485a278b7321e4092d5fc2,3002,672,3633,5,7312,Baldwinee7303e7b8f3d839fa7ea29f0cdfcd9bc68d0d1efb485a278b7321e4092d5fc2
Putnam,ee7303e7b8f3d839fa7ea29f0cdfcd9bc68d0d1efb485a278b7321e4092d5fc2,390,103,510,1,1004,Putnamee7303e7b8f3d839fa7ea29f0cdfcd9bc68d0d1efb485a278b7321e4092d5fc2
Houston,1cabcee148871e08bbebc3595c6505ab8fda41c8544e09bc54d680f6f874490b,5899,827,14594,26,21346,Houston1cabcee148871e08bbebc3595c6505ab8fda41c8544e09bc54d680f6f874490b
Houston,aafcfdf5a3982d9968c23e8bf0a4c408a99ebf43829442afedc1beb9b922329e,5027,754,9127,15,14923,Houstonaafcfdf5a3982d9968c23e8bf0a4c408a99ebf43829442afedc1beb9b922329e
Crisp,86eb1078cf7cac51d2a61c026004e6416ac1a981d245cf4590b47038c50644e4,1857,295,3782,10,5944,Crisp86eb1078cf7cac51d2a61c026004e6416ac1a981d245cf4590b47038c50644e4
Houston,86eb1078cf7cac51d2a61c026004e6416ac1a981d245cf4590b47038c50644e4,1473,108,2408,3,3992,Houston86eb1078cf7cac51d2a61c026004e6416ac1a981d245cf4590b47038c50644e4
Pulaski,86eb1078cf7cac51d2a61c026004e6416ac1a981d245cf4590b47038c50644e4,661,145,1953,1,2760,Pulaski86eb1078cf7cac51d2a61c026004e6416ac1a981d245cf4590b47038c50644e4
Wilcox,86eb1078cf7cac51d2a61c026004e6416ac1a981d245cf4590b47038c50644e4,1170,188,1005,0,2363,Wilcox86eb1078cf7cac51d2a61c026004e6416ac1a981d245cf4590b47038c50644e4
Dodge,f254364c6ab058b0c08b330b5754a5115a4e2bae9c9f4780ad34f1c084f8063a,3022,258,2117,0,5397,Dodgef254364c6ab058b0c08b330b5754a5115a4e2bae9c9f4780ad34f1c084f8063a
Jeff Davis,f254364c6ab058b0c08b330b5754a5115a4e2bae9c9f4780ad34f1c084f8063a,610,51,677,0,1338,Jeff Davisf254364c6ab058b0c08b330b5754a5115a4e2bae9c9f4780ad34f1c084f8063a
Laurens,f254364c6ab058b0c08b330b5754a5115a4e2bae9c9f4780ad34f1c084f8063a,508,15,143,0,666,Laurensf254364c6ab058b0c08b330b5754a5115a4e2bae9c9f4780ad34f1c084f8063a
Telfair,f254364c6ab058b0c08b330b5754a5115a4e2bae9c9f4780ad34f1c084f8063a,1478,121,1059,1,2659,Telfairf254364c6ab058b0c08b330b5754a5115a4e2bae9c9f4780ad34f1c084f8063a
Wheeler,f254364c6ab058b0c08b330b5754a5115a4e2bae9c9f4780ad34f1c084f8063a,741,101,717,3,1562,Wheelerf254364c6ab058b0c08b330b5754a5115a4e2bae9c9f4780ad34f1c084f8063a
Johnson,643b8fbd4484a433d29774a838fdfda4f2fba1f60d8b559dcee904c6aa111483,698,78,686,0,1462,Johnson643b8fbd4484a433d29774a838fdfda4f2fba1f60d8b559dcee904c6aa111483
Laurens,643b8fbd4484a433d29774a838fdfda4f2fba1f60d8b559dcee904c6aa111483,6749,790,6111,3,13653,Laurens643b8fbd4484a433d29774a838fdfda4f2fba1f60d8b559dcee904c6aa111483
Treutlen,643b8fbd4484a433d29774a838fdfda4f2fba1f60d8b559dcee904c6aa111483,694,128,1145,2,1969,Treutlen643b8fbd4484a433d29774a838fdfda4f2fba1f60d8b559dcee904c6aa111483
Calhoun,9003a2d95b442110712f8edea3a6d0301382fa0bb08f4231b3d68e45778a117b,520,65,396,1,982,Calhoun9003a2d95b442110712f8edea3a6d0301382fa0bb08f4231b3d68e45778a117b
Clay,9003a2d95b442110712f8edea3a6d0301382fa0bb08f4231b3d68e45778a117b,285,69,443,2,799,Clay9003a2d95b442110712f8edea3a6d0301382fa0bb08f4231b3d68e45778a117b
Dougherty,9003a2d95b442110712f8edea3a6d0301382fa0bb08f4231b3d68e45778a117b,721,70,555,0,1346,Dougherty9003a2d95b442110712f8edea3a6d0301382fa0bb08f4231b3d68e45778a117b
Early,9003a2d95b442110712f8edea3a6d0301382fa0bb08f4231b3d68e45778a117b,1202,231,1434,1,2868,Early9003a2d95b442110712f8edea3a6d0301382fa0bb08f4231b3d68e45778a117b
Quitman,9003a2d95b442110712f8edea3a6d0301382fa0bb08f4231b3d68e45778a117b,258,39,297,0,594,Quitman9003a2d95b442110712f8edea3a6d0301382fa0bb08f4231b3d68e45778a117b
Randolph,9003a2d95b442110712f8edea3a6d0301382fa0bb08f4231b3d68e45778a117b,906,88,799,2,1795,Randolph9003a2d95b442110712f8edea3a6d0301382fa0bb08f4231b3d68e45778a117b
Stewart,9003a2d95b442110712f8edea3a6d0301382fa0bb08f4231b3d68e45778a117b,462,215,453,3,1133,Stewart9003a2d95b442110712f8edea3a6d0301382fa0bb08f4231b3d68e45778a117b
Terrell,9003a2d95b442110712f8edea3a6d0301382fa0bb08f4231b3d68e45778a117b,1105,160,1165,2,2432,Terrell9003a2d95b442110712f8edea3a6d0301382fa0bb08f4231b3d68e45778a117b
Webster,9003a2d95b442110712f8edea3a6d0301382fa0bb08f4231b3d68e45778a117b,300,77,349,0,726,Webster9003a2d95b442110712f8edea3a6d0301382fa0bb08f4231b3d68e45778a117b
Calhoun,fe04ea2a7b5e29a2e1f2e6d317573b3f3077a6e25cb58ab77de1f20addc7148f,662,82,254,0,998,Calhounfe04ea2a7b5e29a2e1f2e6d317573b3f3077a6e25cb58ab77de1f20addc7148f
Clay,fe04ea2a7b5e29a2e1f2e6d317573b3f3077a6e25cb58ab77de1f20addc7148f,226,37,170,0,433,Clayfe04ea2a7b5e29a2e1f2e6d317573b3f3077a6e25cb58ab77de1f20addc7148f
Dougherty,fe04ea2a7b5e29a2e1f2e6d317573b3f3077a6e25cb58ab77de1f20addc7148f,348,30,562,1,941,Doughertyfe04ea2a7b5e29a2e1f2e6d317573b3f3077a6e25cb58ab77de1f20addc7148f
Early,fe04ea2a7b5e29a2e1f2e6d317573b3f3077a6e25cb58ab77de1f20addc7148f,894,120,708,0,1722,Earlyfe04ea2a7b5e29a2e1f2e6d317573b3f3077a6e25cb58ab77de1f20addc7148f
Quitman,fe04ea2a7b5e29a2e1f2e6d317573b3f3077a6e25cb58ab77de1f20addc7148f,158,12,151,0,321,Quitmanfe04ea2a7b5e29a2e1f2e6d317573b3f3077a6e25cb58ab77de1f20addc7148f
Randolph,fe04ea2a7b5e29a2e1f2e6d317573b3f3077a6e25cb58ab77de1f20addc7148f,463,91,417,0,971,Randolphfe04ea2a7b5e29a2e1f2e6d317573b3f3077a6e25cb58ab77de1f20addc7148f
Stewart,fe04ea2a7b5e29a2e1f2e6d317573b3f3077a6e25cb58ab77de1f20addc7148f,344,101,199,1,645,Stewartfe04ea2a7b5e29a2e1f2e6d317573b3f3077a6e25cb58ab77de1f20addc7148f
Terrell,fe04ea2a7b5e29a2e1f2e6d317573b3f3077a6e25cb58ab77de1f20addc7148f,714,91,596,0,1401,Terrellfe04ea2a7b5e29a2e1f2e6d317573b3f3077a6e25cb58ab77de1f20addc7148f
Webster,fe04ea2a7b5e29a2e1f2e6d317573b3f3077a6e25cb58ab77de1f20addc7148f,151,36,106,1,294,Websterfe04ea2a7b5e29a2e1f2e6d317573b3f3077a6e25cb58ab77de1f20addc7148f
Lee,db930aa2f07459da163a808093eff7109d694fc5061a7664cdbb0373476ecaa5,5763,409,6101,5,12278,Leedb930aa2f07459da163a808093eff7109d694fc5061a7664cdbb0373476ecaa5
Sumter,db930aa2f07459da163a808093eff7109d694fc5061a7664cdbb0373476ecaa5,580,62,427,0,1069,Sumterdb930aa2f07459da163a808093eff7109d694fc5061a7664cdbb0373476ecaa5
Worth,db930aa2f07459da163a808093eff7109d694fc5061a7664cdbb0373476ecaa5,3827,207,2861,9,6904,Worthdb930aa2f07459da163a808093eff7109d694fc5061a7664cdbb0373476ecaa5
Dougherty,f2f27f32f68e5de92c36576c77c46125a0adf954099ec3115ee622e64488bf09,8190,712,5890,49,14841,Doughertyf2f27f32f68e5de92c36576c77c46125a0adf954099ec3115ee622e64488bf09
Baker,b96733876db97c0dd8e0a9ce4320f6c42625346c8c7885a09987ae7c84e1bb9d,514,95,399,2,1010,Bakerb96733876db97c0dd8e0a9ce4320f6c42625346c8c7885a09987ae7c84e1bb9d
Dougherty,b96733876db97c0dd8e0a9ce4320f6c42625346c8c7885a09987ae7c84e1bb9d,6070,523,5165,15,11773,Doughertyb96733876db97c0dd8e0a9ce4320f6c42625346c8c7885a09987ae7c84e1bb9d
Miller,b96733876db97c0dd8e0a9ce4320f6c42625346c8c7885a09987ae7c84e1bb9d,798,116,799,2,1715,Millerb96733876db97c0dd8e0a9ce4320f6c42625346c8c7885a09987ae7c84e1bb9d
Seminole,b96733876db97c0dd8e0a9ce4320f6c42625346c8c7885a09987ae7c84e1bb9d,1484,127,959,5,2575,Seminoleb96733876db97c0dd8e0a9ce4320f6c42625346c8c7885a09987ae7c84e1bb9d
Ben Hill,8358292caa51fed90387156f12ca3ebc82e9a05d7b24da4b5c2df77d02c82fed,1232,168,3155,7,4562,Ben Hill8358292caa51fed90387156f12ca3ebc82e9a05d7b24da4b5c2df77d02c82fed
Coffee,8358292caa51fed90387156f12ca3ebc82e9a05d7b24da4b5c2df77d02c82fed,734,64,877,0,1675,Coffee8358292caa51fed90387156f12ca3ebc82e9a05d7b24da4b5c2df77d02c82fed
Irwin,8358292caa51fed90387156f12ca3ebc82e9a05d7b24da4b5c2df77d02c82fed,1438,99,1486,5,3028,Irwin8358292caa51fed90387156f12ca3ebc82e9a05d7b24da4b5c2df77d02c82fed
Tift,8358292caa51fed90387156f12ca3ebc82e9a05d7b24da4b5c2df77d02c82fed,1718,153,2648,4,4523,Tift8358292caa51fed90387156f12ca3ebc82e9a05d7b24da4b5c2df77d02c82fed
Turner,8358292caa51fed90387156f12ca3ebc82e9a05d7b24da4b5c2df77d02c82fed,927,68,1713,3,2711,Turner8358292caa51fed90387156f12ca3ebc82e9a05d7b24da4b5c2df77d02c82fed
Appling,d15925a57cfd71fe558b1aca05e260b851676edd61910422ecb29907ca105494,2196,307,1720,2,4225,Applingd15925a57cfd71fe558b1aca05e260b851676edd61910422ecb29907ca105494
Jeff Davis,d15925a57cfd71fe558b1aca05e260b851676edd61910422ecb29907ca105494,456,42,635,1,1134,Jeff Davisd15925a57cfd71fe558b1aca05e260b851676edd61910422ecb29907ca105494
Montgomery,d15925a57cfd71fe558b1aca05e260b851676edd61910422ecb29907ca105494,1749,94,1050,0,2893,Montgomeryd15925a57cfd71fe558b1aca05e260b851676edd61910422ecb29907ca105494
Toombs,d15925a57cfd71fe558b1aca05e260b851676edd61910422ecb29907ca105494,2936,413,3883,1,7233,Toombsd15925a57cfd71fe558b1aca05e260b851676edd61910422ecb29907ca105494
Evans,3c35534e260b3cd7181d15d22d65b0f5d85254785baffa857a27c2f8a6546d17,878,131,1821,0,2830,Evans3c35534e260b3cd7181d15d22d65b0f5d85254785baffa857a27c2f8a6546d17
Tattnall,3c35534e260b3cd7181d15d22d65b0f5d85254785baffa857a27c2f8a6546d17,2151,427,2819,5,5402,Tattnall3c35534e260b3cd7181d15d22d65b0f5d85254785baffa857a27c2f8a6546d17
Wayne,3c35534e260b3cd7181d15d22d65b0f5d85254785baffa857a27c2f8a6546d17,1750,177,2847,3,4777,Wayne3c35534e260b3cd7181d15d22d65b0f5d85254785baffa857a27c2f8a6546d17
Bulloch,762051a5af35f2890371cb6162b0e0ca1808c4f08b710cecfe66178e0fb80638,1575,169,1847,1,3592,Bulloch762051a5af35f2890371cb6162b0e0ca1808c4f08b710cecfe66178e0fb80638
Candler,762051a5af35f2890371cb6162b0e0ca1808c4f08b710cecfe66178e0fb80638,800,112,2229,3,3144,Candler762051a5af35f2890371cb6162b0e0ca1808c4f08b710cecfe66178e0fb80638
Emanuel,762051a5af35f2890371cb6162b0e0ca1808c4f08b710cecfe66178e0fb80638,3362,268,2764,7,6401,Emanuel762051a5af35f2890371cb6162b0e0ca1808c4f08b710cecfe66178e0fb80638
Jenkins,762051a5af35f2890371cb6162b0e0ca1808c4f08b710cecfe66178e0fb80638,931,126,1224,7,2288,Jenkins762051a5af35f2890371cb6162b0e0ca1808c4f08b710cecfe66178e0fb80638
Bulloch,a932fa9670574436132a739609a99ea61724d1c567d501b7539597bb458a3081,2044,200,2342,5,4591,Bullocha932fa9670574436132a739609a99ea61724d1c567d501b7539597bb458a3081
Effingham,a932fa9670574436132a739609a99ea61724d1c567d501b7539597bb458a3081,3574,214,4800,2,8590,Effinghama932fa9670574436132a739609a99ea61724d1c567d501b7539597bb458a3081
Screven,a932fa9670574436132a739609a99ea61724d1c567d501b7539597bb458a3081,2070,119,2143,0,4332,Screvena932fa9670574436132a739609a99ea61724d1c567d501b7539597bb458a3081
Bryan,e976bc39f54f942fbd98db36cef98348854f80f3af1d382c3346e3f71312e12d,1463,65,1269,1,2798,Bryane976bc39f54f942fbd98db36cef98348854f80f3af1d382c3346e3f71312e12d
Bulloch,e976bc39f54f942fbd98db36cef98348854f80f3af1d382c3346e3f71312e12d,5098,389,4506,16,10009,Bulloche976bc39f54f942fbd98db36cef98348854f80f3af1d382c3346e3f71312e12d
Bryan,8f6d2621d7a873c533e1c960269db9f48b36105caf6a0089c01d15a612750d3a,445,30,356,1,832,Bryan8f6d2621d7a873c533e1c960269db9f48b36105caf6a0089c01d15a612750d3a
Bulloch,8f6d2621d7a873c533e1c960269db9f48b36105caf6a0089c01d15a612750d3a,1916,144,2390,10,4460,Bulloch8f6d2621d7a873c533e1c960269db9f48b36105caf6a0089c01d15a612750d3a
Chatham,32716b4edafff3375e50582338877060e380c236fe4b6178641fed276d47680f,6058,304,2554,8,8924,Chatham32716b4edafff3375e50582338877060e380c236fe4b6178641fed276d47680f
Effingham,32716b4edafff3375e50582338877060e380c236fe4b6178641fed276d47680f,5932,323,5655,1,11911,Effingham32716b4edafff3375e50582338877060e380c236fe4b6178641fed276d47680f
Chatham,7e06bdcfb0cfbb26587dc8b255a67880764613fc88b0d84dc702552c5ec25757,9508,682,4879,23,15092,Chatham7e06bdcfb0cfbb26587dc8b255a67880764613fc88b0d84dc702552c5ec25757
Chatham,9c2718bfa863c70d826dd8c4b354e32ef3eadb1308d7c74108b0f7ca8028224d,10057,906,4670,16,15649,Chatham9c2718bfa863c70d826dd8c4b354e32ef3eadb1308d7c74108b0f7ca8028224d
Bryan,679ccbe931fcb5bd1905950a51796f5b6eb2755cef21447e3689e805732c9f5d,1881,197,3175,2,5255,Bryan679ccbe931fcb5bd1905950a51796f5b6eb2755cef21447e3689e805732c9f5d
Chatham,679ccbe931fcb5bd1905950a51796f5b6eb2755cef21447e3689e805732c9f5d,5987,336,3089,14,9426,Chatham679ccbe931fcb5bd1905950a51796f5b6eb2755cef21447e3689e805732c9f5d
Liberty,679ccbe931fcb5bd1905950a51796f5b6eb2755cef21447e3689e805732c9f5d,179,16,96,1,292,Liberty679ccbe931fcb5bd1905950a51796f5b6eb2755cef21447e3689e805732c9f5d
Chatham,e58f65dadceca25d1a1651abcd81530462f89f1b9440592d63746a4f769713ea,11802,750,5632,13,18197,Chathame58f65dadceca25d1a1651abcd81530462f89f1b9440592d63746a4f769713ea
Bryan,14927e7fd10812a0d374198ac3d251f879bcceac871458cf4645de8b953d504a,1196,106,2975,2,4279,Bryan14927e7fd10812a0d374198ac3d251f879bcceac871458cf4645de8b953d504a
Chatham,14927e7fd10812a0d374198ac3d251f879bcceac871458cf4645de8b953d504a,14462,937,6559,18,21976,Chatham14927e7fd10812a0d374198ac3d251f879bcceac871458cf4645de8b953d504a
Glynn,0efa2f581b74b8f53ab0078979a582ce1c89427848a48d6f84443d706a49896e,4238,332,4909,9,9488,Glynn0efa2f581b74b8f53ab0078979a582ce1c89427848a48d6f84443d706a49896e
Long,0efa2f581b74b8f53ab0078979a582ce1c89427848a48d6f84443d706a49896e,1543,60,1482,6,3091,Long0efa2f581b74b8f53ab0078979a582ce1c89427848a48d6f84443d706a49896e
McIntosh,0efa2f581b74b8f53ab0078979a582ce1c89427848a48d6f84443d706a49896e,1647,434,2204,7,4292,McIntosh0efa2f581b74b8f53ab0078979a582ce1c89427848a48d6f84443d706a49896e
Liberty,edde11880e9555d088a628dc2daca9a5bc4b62e3011aaba093ff9a02186f0fdb,4950,475,7481,33,12939,Libertyedde11880e9555d088a628dc2daca9a5bc4b62e3011aaba093ff9a02186f0fdb
Bacon,9611dfd74eea17872f008a30aa1e3f7116c724631d1e5caa476ea5ef4b532c90,1066,126,1905,5,3102,Bacon9611dfd74eea17872f008a30aa1e3f7116c724631d1e5caa476ea5ef4b532c90
Coffee,9611dfd74eea17872f008a30aa1e3f7116c724631d1e5caa476ea5ef4b532c90,2805,282,5836,0,8923,Coffee9611dfd74eea17872f008a30aa1e3f7116c724631d1e5caa476ea5ef4b532c90
Jeff Davis,9611dfd74eea17872f008a30aa1e3f7116c724631d1e5caa476ea5ef4b532c90,705,65,725,1,1496,Jeff Davis9611dfd74eea17872f008a30aa1e3f7116c724631d1e5caa476ea5ef4b532c90
Berrien,bd768917018a1b595ac70595e374e0962d358d69a17323fbfc226f242e757535,2626,334,2981,18,5959,Berrienbd768917018a1b595ac70595e374e0962d358d69a17323fbfc226f242e757535
Cook,bd768917018a1b595ac70595e374e0962d358d69a17323fbfc226f242e757535,2159,189,2867,0,5215,Cookbd768917018a1b595ac70595e374e0962d358d69a17323fbfc226f242e757535
Tift,bd768917018a1b595ac70595e374e0962d358d69a17323fbfc226f242e757535,1491,184,2707,2,4384,Tiftbd768917018a1b595ac70595e374e0962d358d69a17323fbfc226f242e757535
Colquitt,84fdad204a20f49b2a8140795b77e48839090a809b4d0ce1093e1297dd1b35c9,1988,78,1342,1,3409,Colquitt84fdad204a20f49b2a8140795b77e48839090a809b4d0ce1093e1297dd1b35c9
Decatur,84fdad204a20f49b2a8140795b77e48839090a809b4d0ce1093e1297dd1b35c9,1819,243,3108,11,5181,Decatur84fdad204a20f49b2a8140795b77e48839090a809b4d0ce1093e1297dd1b35c9
Mitchell,84fdad204a20f49b2a8140795b77e48839090a809b4d0ce1093e1297dd1b35c9,2787,365,2912,8,6072,Mitchell84fdad204a20f49b2a8140795b77e48839090a809b4d0ce1093e1297dd1b35c9
Colquitt,bb0f3fa7a351c70b5a232117edb839d7e043c90d4cccacbab56cd4862746a9ba,3744,289,3860,5,7898,Colquittbb0f3fa7a351c70b5a232117edb839d7e043c90d4cccacbab56cd4862746a9ba
Thomas,bb0f3fa7a351c70b5a232117edb839d7e043c90d4cccacbab56cd4862746a9ba,1393,69,965,0,2427,Thomasbb0f3fa7a351c70b5a232117edb839d7e043c90d4cccacbab56cd4862746a9ba
Tift,bb0f3fa7a351c70b5a232117edb839d7e043c90d4cccacbab56cd4862746a9ba,1265,90,1216,2,2573,Tiftbb0f3fa7a351c70b5a232117edb839d7e043c90d4cccacbab56cd4862746a9ba
Decatur,ade25771698ba256c5799f798a24d7b71e1a45311aeac2a7ee64ea007c2f2301,960,98,893,2,1953,Decaturade25771698ba256c5799f798a24d7b71e1a45311aeac2a7ee64ea007c2f2301
Grady,ade25771698ba256c5799f798a24d7b71e1a45311aeac2a7ee64ea007c2f2301,2637,181,3266,3,6087,Gradyade25771698ba256c5799f798a24d7b71e1a45311aeac2a7ee64ea007c2f2301
Thomas,ade25771698ba256c5799f798a24d7b71e1a45311aeac2a7ee64ea007c2f2301,1392,231,2915,0,4538,Thomasade25771698ba256c5799f798a24d7b71e1a45311aeac2a7ee64ea007c2f2301
Decatur,e4ee1ce1d82f3c2cda9b177f1d338a8578582975f58759c1bdb937a51875fb40,576,77,466,8,1127,Decature4ee1ce1d82f3c2cda9b177f1d338a8578582975f58759c1bdb937a51875fb40
Grady,e4ee1ce1d82f3c2cda9b177f1d338a8578582975f58759c1bdb937a51875fb40,1132,104,1607,9,2852,Gradye4ee1ce1d82f3c2cda9b177f1d338a8578582975f58759c1bdb937a51875fb40
Thomas,e4ee1ce1d82f3c2cda9b177f1d338a8578582975f58759c1bdb937a51875fb40,1413,211,2416,2,4042,Thomase4ee1ce1d82f3c2cda9b177f1d338a8578582975f58759c1bdb937a51875fb40
Camden,315681be098801f1b25307f4f32e8795e2bd4258ad2a964b2b14ddb3d6cea8c8,1037,113,1341,5,2496,Camden315681be098801f1b25307f4f32e8795e2bd4258ad2a964b2b14ddb3d6cea8c8
Charlton,315681be098801f1b25307f4f32e8795e2bd4258ad2a964b2b14ddb3d6cea8c8,1116,154,1470,6,2746,Charlton315681be098801f1b25307f4f32e8795e2bd4258ad2a964b2b14ddb3d6cea8c8
Clinch,315681be098801f1b25307f4f32e8795e2bd4258ad2a964b2b14ddb3d6cea8c8,781,66,1060,4,1911,Clinch315681be098801f1b25307f4f32e8795e2bd4258ad2a964b2b14ddb3d6cea8c8
Echols,315681be098801f1b25307f4f32e8795e2bd4258ad2a964b2b14ddb3d6cea8c8,435,36,600,0,1071,Echols315681be098801f1b25307f4f32e8795e2bd4258ad2a964b2b14ddb3d6cea8c8
Lowndes,315681be098801f1b25307f4f32e8795e2bd4258ad2a964b2b14ddb3d6cea8c8,2475,192,2762,45,5474,Lowndes315681be098801f1b25307f4f32e8795e2bd4258ad2a964b2b14ddb3d6cea8c8
Ware,315681be098801f1b25307f4f32e8795e2bd4258ad2a964b2b14ddb3d6cea8c8,663,59,707,1,1430,Ware315681be098801f1b25307f4f32e8795e2bd4258ad2a964b2b14ddb3d6cea8c8
Brooks,477b625c77291c9fc8fd4a97f6c872924b9185db44b8985bb06d03149ebf673b,2253,317,2199,39,4808,Brooks477b625c77291c9fc8fd4a97f6c872924b9185db44b8985bb06d03149ebf673b
Lowndes,477b625c77291c9fc8fd4a97f6c872924b9185db44b8985bb06d03149ebf673b,2091,351,6480,97,9019,Lowndes477b625c77291c9fc8fd4a97f6c872924b9185db44b8985bb06d03149ebf673b
Thomas,477b625c77291c9fc8fd4a97f6c872924b9185db44b8985bb06d03149ebf673b,2186,247,3271,0,5704,Thomas477b625c77291c9fc8fd4a97f6c872924b9185db44b8985bb06d03149ebf673b
Atkinson,1a34d05bc3539b7dde1f1eaf5749a0455ef24167d2faff52401812ae4a03b195,919,79,992,1,1991,Atkinson1a34d05bc3539b7dde1f1eaf5749a0455ef24167d2faff52401812ae4a03b195
Lanier,1a34d05bc3539b7dde1f1eaf5749a0455ef24167d2faff52401812ae4a03b195,1028,59,1426,1,2514,Lanier1a34d05bc3539b7dde1f1eaf5749a0455ef24167d2faff52401812ae4a03b195
Lowndes,1a34d05bc3539b7dde1f1eaf5749a0455ef24167d2faff52401812ae4a03b195,1813,177,3323,63,5376,Lowndes1a34d05bc3539b7dde1f1eaf5749a0455ef24167d2faff52401812ae4a03b195
Ware,1a34d05bc3539b7dde1f1eaf5749a0455ef24167d2faff52401812ae4a03b195,2230,254,2522,4,5010,Ware1a34d05bc3539b7dde1f1eaf5749a0455ef24167d2faff52401812ae4a03b195
Lowndes,99ecc72dd0dafeeb8a0cc0aec3bf78ebcba5f32ffd09a5f862ee32c5c22a84c7,1373,240,3431,60,5104,Lowndes99ecc72dd0dafeeb8a0cc0aec3bf78ebcba5f32ffd09a5f862ee32c5c22a84c7
Lowndes,198f1bb27bad66f77c52eb032e4553c1a1b10ba29ffdc043f460d2559c156ac0,2817,390,5842,177,9226,Lowndes198f1bb27bad66f77c52eb032e4553c1a1b10ba29ffdc043f460d2559c156ac0
Appling,3cac74b424718298d3fbb869ebd573a16c7eab8899b17f55659bb4b4583eeb47,871,96,558,0,1525,Appling3cac74b424718298d3fbb869ebd573a16c7eab8899b17f55659bb4b4583eeb47
Brantley,3cac74b424718298d3fbb869ebd573a16c7eab8899b17f55659bb4b4583eeb47,2484,198,2718,4,5404,Brantley3cac74b424718298d3fbb869ebd573a16c7eab8899b17f55659bb4b4583eeb47
Pierce,3cac74b424718298d3fbb869ebd573a16c7eab8899b17f55659bb4b4583eeb47,1852,303,4383,1,6539,Pierce3cac74b424718298d3fbb869ebd573a16c7eab8899b17f55659bb4b4583eeb47
Wayne,3cac74b424718298d3fbb869ebd573a16c7eab8899b17f55659bb4b4583eeb47,1915,144,1822,5,3886,Wayne3cac74b424718298d3fbb869ebd573a16c7eab8899b17f55659bb4b4583eeb47
Glynn,4581e77deb0b86d45302ad55db448bc81d10d104e43015debdb216787fbd0a3c,7018,752,9262,23,17055,Glynn4581e77deb0b86d45302ad55db448bc81d10d104e43015debdb216787fbd0a3c
Camden,c55012e574cb16d329f9b3805efa6234455cc583bd8b5ec5285c3d63fbabdf1d,4945,691,6748,11,12395,Camdenc55012e574cb16d329f9b3805efa6234455cc583bd8b5ec5285c3d63fbabdf1d
Charlton,c55012e574cb16d329f9b3805efa6234455cc583bd8b5ec5285c3d63fbabdf1d,170,8,156,0,334,Charltonc55012e574cb16d329f9b3805efa6234455cc583bd8b5ec5285c3d63fbabdf1d
Ware,c55012e574cb16d329f9b3805efa6234455cc583bd8b5ec5285c3d63fbabdf1d,1167,152,2119,1,3439,Warec55012e574cb16d329f9b3805efa6234455cc583bd8b5ec5285c3d63fbabdf1d
Atkinson,4acadfc1e5cdccb1ae87d4880eee41b98b850426984b754348631db8a529a541,928,74,991,1,1994,Atkinson4acadfc1e5cdccb1ae87d4880eee41b98b850426984b754348631db8a529a541
Berrien,4acadfc1e5cdccb1ae87d4880eee41b98b850426984b754348631db8a529a541,2602,326,2968,18,5914,Berrien4acadfc1e5cdccb1ae87d4880eee41b98b850426984b754348631db8a529a541
Clinch,4acadfc1e5cdccb1ae87d4880eee41b98b850426984b754348631db8a529a541,781,66,1064,3,1914,Clinch4acadfc1e5cdccb1ae87d4880eee41b98b850426984b754348631db8a529a541
Cook,4acadfc1e5cdccb1ae87d4880eee41b98b850426984b754348631db8a529a541,2118,180,2766,0,5064,Cook4acadfc1e5cdccb1ae87d4880eee41b98b850426984b754348631db8a529a541
Lanier,4acadfc1e5cdccb1ae87d4880eee41b98b850426984b754348631db8a529a541,958,61,1316,1,2336,Lanier4acadfc1e5cdccb1ae87d4880eee41b98b850426984b754348631db8a529a541
Newton,98940f43b8e7bb1d4f4f792b46c41b7ef586c5fad73fa489305f8d9239712f7d,15118,1472,14683,4,31277,Newton98940f43b8e7bb1d4f4f792b46c41b7ef586c5fad73fa489305f8d9239712f7d
Walton,98940f43b8e7bb1d4f4f792b46c41b7ef586c5fad73fa489305f8d9239712f7d,17595,1372,14823,33,33823,Walton98940f43b8e7bb1d4f4f792b46c41b7ef586c5fad73fa489305f8d9239712f7d
Fannin,2b2547778c2ced47bc8fecad4b8ca115a36e2d84d64dd60b223cc998635e306b,4285,624,4917,7,9833,Fannin2b2547778c2ced47bc8fecad4b8ca115a36e2d84d64dd60b223cc998635e306b
Gilmer,2b2547778c2ced47bc8fecad4b8ca115a36e2d84d64dd60b223cc998635e306b,4420,540,5612,10,10582,Gilmer2b2547778c2ced47bc8fecad4b8ca115a36e2d84d64dd60b223cc998635e306b
Pickens,2b2547778c2ced47bc8fecad4b8ca115a36e2d84d64dd60b223cc998635e306b,4676,216,7048,1,11941,Pickens2b2547778c2ced47bc8fecad4b8ca115a36e2d84d64dd60b223cc998635e306b
Fulton,895f2f3c740ab955ca181197191ae00bdde64073260cc560b75715445c260175,124394,15605,207214,1002,348215,Fulton895f2f3c740ab955ca181197191ae00bdde64073260cc560b75715445c260175
Burke,18abbed2d2edb686c83061574871f5f2d1e5e5d2fc8aab8031e9aaa73db86d21,3444,580,2720,0,6744,Burke18abbed2d2edb686c83061574871f5f2d1e5e5d2fc8aab8031e9aaa73db86d21
Columbia,18abbed2d2edb686c83061574871f5f2d1e5e5d2fc8aab8031e9aaa73db86d21,22518,2549,29966,23,55056,Columbia18abbed2d2edb686c83061574871f5f2d1e5e5d2fc8aab8031e9aaa73db86d21
Richmond,18abbed2d2edb686c83061574871f5f2d1e5e5d2fc8aab8031e9aaa73db86d21,24805,2955,23720,63,51543,Richmond18abbed2d2edb686c83061574871f5f2d1e5e5d2fc8aab8031e9aaa73db86d21
Cherokee,43f374865456e6967f2dc033e874424c51240d6ca390d2fed898a930eb90b797,38682,4180,51899,21,94782,Cherokee43f374865456e6967f2dc033e874424c51240d6ca390d2fed898a930eb90b797
Appling,1dd13e8c6602c5440c6eab96995d433750a3846a9231ed4a872a491eae7d811a,3072,412,2283,2,5769,Appling1dd13e8c6602c5440c6eab96995d433750a3846a9231ed4a872a491eae7d811a
Camden,1dd13e8c6602c5440c6eab96995d433750a3846a9231ed4a872a491eae7d811a,6028,841,8260,16,15145,Camden1dd13e8c6602c5440c6eab96995d433750a3846a9231ed4a872a491eae7d811a
Glynn,1dd13e8c6602c5440c6eab96995d433750a3846a9231ed4a872a491eae7d811a,11243,1073,14212,39,26567,Glynn1dd13e8c6602c5440c6eab96995d433750a3846a9231ed4a872a491eae7d811a
Jeff Davis,1dd13e8c6602c5440c6eab96995d433750a3846a9231ed4a872a491eae7d811a,1795,168,2048,2,4013,Jeff Davis1dd13e8c6602c5440c6eab96995d433750a3846a9231ed4a872a491eae7d811a
Wayne,1dd13e8c6602c5440c6eab96995d433750a3846a9231ed4a872a491eae7d811a,3687,327,4707,9,8730,Wayne1dd13e8c6602c5440c6eab96995d433750a3846a9231ed4a872a491eae7d811a
Chattahoochee,57dd280c0e6907efad66861399627844e77da6a809dc8b17c04870b9c4709c62,541,37,454,5,1037,Chattahoochee57dd280c0e6907efad66861399627844e77da6a809dc8b17c04870b9c4709c62
Harris,57dd280c0e6907efad66861399627844e77da6a809dc8b17c04870b9c4709c62,4915,502,6065,1,11483,Harris57dd280c0e6907efad66861399627844e77da6a809dc8b17c04870b9c4709c62
Marion,57dd280c0e6907efad66861399627844e77da6a809dc8b17c04870b9c4709c62,1191,208,983,0,2382,Marion57dd280c0e6907efad66861399627844e77da6a809dc8b17c04870b9c4709c62
Muscogee,57dd280c0e6907efad66861399627844e77da6a809dc8b17c04870b9c4709c62,25038,3064,27710,101,55913,Muscogee57dd280c0e6907efad66861399627844e77da6a809dc8b17c04870b9c4709c62
Talbot,57dd280c0e6907efad66861399627844e77da6a809dc8b17c04870b9c4709c62,1390,455,608,0,2453,Talbot57dd280c0e6907efad66861399627844e77da6a809dc8b17c04870b9c4709c62
Taylor,57dd280c0e6907efad66861399627844e77da6a809dc8b17c04870b9c4709c62,1047,214,1275,0,2536,Taylor57dd280c0e6907efad66861399627844e77da6a809dc8b17c04870b9c4709c62
Bartow,b10e9d1846825be9f5e7dce7a7c4354368059057b7eff484fe914f750cc1dc09,17708,1226,15007,23,33964,Bartowb10e9d1846825be9f5e7dce7a7c4354368059057b7eff484fe914f750cc1dc09
Gordon,b10e9d1846825be9f5e7dce7a7c4354368059057b7eff484fe914f750cc1dc09,7520,472,7733,17,15742,Gordonb10e9d1846825be9f5e7dce7a7c4354368059057b7eff484fe914f750cc1dc09
Clayton,1f7d522dc7a08aa67d2748be7d45a7380b7e83a2822adba9b731b627bf495d6a,30504,2556,50710,134,83904,Clayton1f7d522dc7a08aa67d2748be7d45a7380b7e83a2822adba9b731b627bf495d6a
Cobb,fef7dcdc28a556257922f7230aab410261f54623f272aadf4bb43a5491e5e5e9,127535,17374,97427,494,242830,Cobbfef7dcdc28a556257922f7230aab410261f54623f272aadf4bb43a5491e5e5e9
Murray,3dd1db5383e28168fb0a660086987859d5f226114ae64ba977351711d731cea4,5294,287,4604,0,10185,Murray3dd1db5383e28168fb0a660086987859d5f226114ae64ba977351711d731cea4
Whitfield,3dd1db5383e28168fb0a660086987859d5f226114ae64ba977351711d731cea4,13060,938,10886,29,24913,Whitfield3dd1db5383e28168fb0a660086987859d5f226114ae64ba977351711d731cea4
Ben Hill,a700f7336c0cd64e28adbf4c67c825b0dc1c32e3f5b672c664fb3bda09636397,1259,183,3191,6,4639,Ben Hilla700f7336c0cd64e28adbf4c67c825b0dc1c32e3f5b672c664fb3bda09636397
Crisp,a700f7336c0cd64e28adbf4c67c825b0dc1c32e3f5b672c664fb3bda09636397,1838,277,3701,7,5823,Crispa700f7336c0cd64e28adbf4c67c825b0dc1c32e3f5b672c664fb3bda09636397
Dooly,a700f7336c0cd64e28adbf4c67c825b0dc1c32e3f5b672c664fb3bda09636397,1238,128,1274,14,2654,Doolya700f7336c0cd64e28adbf4c67c825b0dc1c32e3f5b672c664fb3bda09636397
Wilcox,a700f7336c0cd64e28adbf4c67c825b0dc1c32e3f5b672c664fb3bda09636397,1164,182,956,0,2302,Wilcoxa700f7336c0cd64e28adbf4c67c825b0dc1c32e3f5b672c664fb3bda09636397
Carroll,d6a054236c6e8f8a7d48de21e7b3bdea4c19d369f823c9f3056cad1c4d249432,15917,1181,19490,67,36655,Carrolld6a054236c6e8f8a7d48de21e7b3bdea4c19d369f823c9f3056cad1c4d249432
Coweta,d6a054236c6e8f8a7d48de21e7b3bdea4c19d369f823c9f3056cad1c4d249432,23406,2343,25997,17,51763,Cowetad6a054236c6e8f8a7d48de21e7b3bdea4c19d369f823c9f3056cad1c4d249432
Heard,d6a054236c6e8f8a7d48de21e7b3bdea4c19d369f823c9f3056cad1c4d249432,2001,215,1426,2,3644,Heardd6a054236c6e8f8a7d48de21e7b3bdea4c19d369f823c9f3056cad1c4d249432
Meriwether,d6a054236c6e8f8a7d48de21e7b3bdea4c19d369f823c9f3056cad1c4d249432,4125,314,2745,3,7187,Meriwetherd6a054236c6e8f8a7d48de21e7b3bdea4c19d369f823c9f3056cad1c4d249432
Troup,d6a054236c6e8f8a7d48de21e7b3bdea4c19d369f823c9f3056cad1c4d249432,9583,1003,10608,169,21363,Troupd6a054236c6e8f8a7d48de21e7b3bdea4c19d369f823c9f3056cad1c4d249432
Dougherty,33ef145da4fdb3ce4f9e61114ecd0a956f190faa4190af4eb7f5771145672801,15566,1331,12496,81,29474,Dougherty33ef145da4fdb3ce4f9e61114ecd0a956f190faa4190af4eb7f5771145672801
Johnson,efe36efb1d3c317e7e8b1e8a5e7dae87a5d5ed3e4a9fab83696341c565e2ccdc,1163,165,1525,0,2853,Johnsonefe36efb1d3c317e7e8b1e8a5e7dae87a5d5ed3e4a9fab83696341c565e2ccdc
Laurens,efe36efb1d3c317e7e8b1e8a5e7dae87a5d5ed3e4a9fab83696341c565e2ccdc,8186,920,6892,3,16001,Laurensefe36efb1d3c317e7e8b1e8a5e7dae87a5d5ed3e4a9fab83696341c565e2ccdc
Treutlen,efe36efb1d3c317e7e8b1e8a5e7dae87a5d5ed3e4a9fab83696341c565e2ccdc,713,125,1179,2,2019,Treutlenefe36efb1d3c317e7e8b1e8a5e7dae87a5d5ed3e4a9fab83696341c565e2ccdc
Twiggs,efe36efb1d3c317e7e8b1e8a5e7dae87a5d5ed3e4a9fab83696341c565e2ccdc,1506,177,1078,0,2761,Twiggsefe36efb1d3c317e7e8b1e8a5e7dae87a5d5ed3e4a9fab83696341c565e2ccdc
Chatham,203a0982e1af58f7c36e1c58886e701cdd3f608058410f0053b421c6bf57ee3e,52857,3545,24867,76,81345,Chatham203a0982e1af58f7c36e1c58886e701cdd3f608058410f0053b421c6bf57ee3e
Henry,d42bc9afc75df1b441769d14c024db303f847a19d11e6cf9c78d39110cdd8e31,19677,1809,48005,114,69605,Henryd42bc9afc75df1b441769d14c024db303f847a19d11e6cf9c78d39110cdd8e31
Fayette,01ad3cea16e2292907e7405ca12f02ece0052feb6cbec05a6bd03d7b4473d542,14693,2124,29330,16,46163,Fayette01ad3cea16e2292907e7405ca12f02ece0052feb6cbec05a6bd03d7b4473d542
Pike,01ad3cea16e2292907e7405ca12f02ece0052feb6cbec05a6bd03d7b4473d542,2906,321,4590,5,7822,Pike01ad3cea16e2292907e7405ca12f02ece0052feb6cbec05a6bd03d7b4473d542
Spalding,01ad3cea16e2292907e7405ca12f02ece0052feb6cbec05a6bd03d7b4473d542,7297,782,11378,11,19468,Spalding01ad3cea16e2292907e7405ca12f02ece0052feb6cbec05a6bd03d7b4473d542
Upson,01ad3cea16e2292907e7405ca12f02ece0052feb6cbec05a6bd03d7b4473d542,2461,387,6283,4,9135,Upson01ad3cea16e2292907e7405ca12f02ece0052feb6cbec05a6bd03d7b4473d542
Gwinnett,e4224165981c101ca271f2ceccd2f977c52d415fac7d6088402d34168bfc8384,119418,14510,104577,1020,239525,Gwinnette4224165981c101ca271f2ceccd2f977c52d415fac7d6088402d34168bfc8384
Houston,2cd7e12784126d9c5a76a1bf558ffbb159a59bc96d3ab76ac227c2e29debfe23,14962,1977,30392,89,47420,Houston2cd7e12784126d9c5a76a1bf558ffbb159a59bc96d3ab76ac227c2e29debfe23
Catoosa,5c9d243b777bd027aab172fae1722b310fd1da21b5012ef63e04c20b234ba2f5,7812,533,14313,9,22667,Catoosa5c9d243b777bd027aab172fae1722b310fd1da21b5012ef63e04c20b234ba2f5
Chattooga,5c9d243b777bd027aab172fae1722b310fd1da21b5012ef63e04c20b234ba2f5,3285,182,3520,5,6992,Chattooga5c9d243b777bd027aab172fae1722b310fd1da21b5012ef63e04c20b234ba2f5
Dade,5c9d243b777bd027aab172fae1722b310fd1da21b5012ef63e04c20b234ba2f5,2725,122,2485,2,5334,Dade5c9d243b777bd027aab172fae1722b310fd1da21b5012ef63e04c20b234ba2f5
Walker,5c9d243b777bd027aab172fae1722b310fd1da21b5012ef63e04c20b234ba2f5,8199,793,11394,11,20397,Walker5c9d243b777bd027aab172fae1722b310fd1da21b5012ef63e04c20b234ba2f5
Bibb,6636d027fb87486cff0434451c4de4c610ef9e1f2a50d9a9a259cb2dfaf5d8c3,24379,3044,23879,184,51486,Bibb6636d027fb87486cff0434451c4de4c610ef9e1f2a50d9a9a259cb2dfaf5d8c3
Crawford,6636d027fb87486cff0434451c4de4c610ef9e1f2a50d9a9a259cb2dfaf5d8c3,1759,212,2030,3,4004,Crawford6636d027fb87486cff0434451c4de4c610ef9e1f2a50d9a9a259cb2dfaf5d8c3
Peach,6636d027fb87486cff0434451c4de4c610ef9e1f2a50d9a9a259cb2dfaf5d8c3,2641,281,5459,21,8402,Peach6636d027fb87486cff0434451c4de4c610ef9e1f2a50d9a9a259cb2dfaf5d8c3
Candler,a579297352a8a8cafc1bc91406ac4cdb39da53a1bad088cdc4df981070b10733,796,111,2156,3,3066,Candlera579297352a8a8cafc1bc91406ac4cdb39da53a1bad088cdc4df981070b10733
Emanuel,a579297352a8a8cafc1bc91406ac4cdb39da53a1bad088cdc4df981070b10733,3249,263,2687,7,6206,Emanuela579297352a8a8cafc1bc91406ac4cdb39da53a1bad088cdc4df981070b10733
Jefferson,a579297352a8a8cafc1bc91406ac4cdb39da53a1bad088cdc4df981070b10733,2143,246,1817,12,4218,Jeffersona579297352a8a8cafc1bc91406ac4cdb39da53a1bad088cdc4df981070b10733
Toombs,a579297352a8a8cafc1bc91406ac4cdb39da53a1bad088cdc4df981070b10733,2882,412,3886,1,7181,Toombsa579297352a8a8cafc1bc91406ac4cdb39da53a1bad088cdc4df981070b10733
Washington,a579297352a8a8cafc1bc91406ac4cdb39da53a1bad088cdc4df981070b10733,2336,385,2624,18,5363,Washingtona579297352a8a8cafc1bc91406ac4cdb39da53a1bad088cdc4df981070b10733
Habersham,e40f2c316b2a73c7a1cbdd94ee721be65cb94eaf2d11ad1275832daac043d922,2869,771,10162,3,13805,Habershame40f2c316b2a73c7a1cbdd94ee721be65cb94eaf2d11ad1275832daac043d922
Rabun,e40f2c316b2a73c7a1cbdd94ee721be65cb94eaf2d11ad1275832daac043d922,1189,734,4714,0,6637,Rabune40f2c316b2a73c7a1cbdd94ee721be65cb94eaf2d11ad1275832daac043d922
Stephens,e40f2c316b2a73c7a1cbdd94ee721be65cb94eaf2d11ad1275832daac043d922,1751,544,6119,3,8417,Stephense40f2c316b2a73c7a1cbdd94ee721be65cb94eaf2d11ad1275832daac043d922
Elbert,c7ec6f44ec3c16d92cbda617388afb0452c9eb9cabddff100b93cf3b7176b52a,2324,362,3490,43,6219,Elbertc7ec6f44ec3c16d92cbda617388afb0452c9eb9cabddff100b93cf3b7176b52a
Franklin,c7ec6f44ec3c16d92cbda617388afb0452c9eb9cabddff100b93cf3b7176b52a,3570,333,3483,0,7386,Franklinc7ec6f44ec3c16d92cbda617388afb0452c9eb9cabddff100b93cf3b7176b52a
Hart,c7ec6f44ec3c16d92cbda617388afb0452c9eb9cabddff100b93cf3b7176b52a,3438,386,4258,0,8082,Hartc7ec6f44ec3c16d92cbda617388afb0452c9eb9cabddff100b93cf3b7176b52a
Madison,c7ec6f44ec3c16d92cbda617388afb0452c9eb9cabddff100b93cf3b7176b52a,4419,404,5110,7,9940,Madisonc7ec6f44ec3c16d92cbda617388afb0452c9eb9cabddff100b93cf3b7176b52a
Oglethorpe,c7ec6f44ec3c16d92cbda617388afb0452c9eb9cabddff100b93cf3b7176b52a,1883,288,3140,1,5312,Oglethorpec7ec6f44ec3c16d92cbda617388afb0452c9eb9cabddff100b93cf3b7176b52a
Baldwin,d468c97b2041f58115875406390992f33bf079d4c811f006f52a11bc48341449,4540,572,6337,6,11455,Baldwind468c97b2041f58115875406390992f33bf079d4c811f006f52a11bc48341449
Greene,d468c97b2041f58115875406390992f33bf079d4c811f006f52a11bc48341449,1988,410,4581,6,6985,Greened468c97b2041f58115875406390992f33bf079d4c811f006f52a11bc48341449
Hancock,d468c97b2041f58115875406390992f33bf079d4c811f006f52a11bc48341449,894,141,720,5,1760,Hancockd468c97b2041f58115875406390992f33bf079d4c811f006f52a11bc48341449
Jasper,d468c97b2041f58115875406390992f33bf079d4c811f006f52a11bc48341449,1956,269,2726,6,4957,Jasperd468c97b2041f58115875406390992f33bf079d4c811f006f52a11bc48341449
Jones,d468c97b2041f58115875406390992f33bf079d4c811f006f52a11bc48341449,3795,535,5735,1,10066,Jonesd468c97b2041f58115875406390992f33bf079d4c811f006f52a11bc48341449
Morgan,d468c97b2041f58115875406390992f33bf079d4c811f006f52a11bc48341449,2961,302,4511,4,7778,Morgand468c97b2041f58115875406390992f33bf079d4c811f006f52a11bc48341449
Putnam,d468c97b2041f58115875406390992f33bf079d4c811f006f52a11bc48341449,2847,474,4358,4,7683,Putnamd468c97b2041f58115875406390992f33bf079d4c811f006f52a11bc48341449
Wilkinson,d468c97b2041f58115875406390992f33bf079d4c811f006f52a11bc48341449,1768,111,950,1,2830,Wilkinsond468c97b2041f58115875406390992f33bf079d4c811f006f52a11bc48341449
Bleckley,8acef249c62a4e5f85501ad4ec76764d2a9f23ba38c41638b9e6f5d6678d3719,1611,183,1995,7,3796,Bleckley8acef249c62a4e5f85501ad4ec76764d2a9f23ba38c41638b9e6f5d6678d3719
Dodge,8acef249c62a4e5f85501ad4ec76764d2a9f23ba38c41638b9e6f5d6678d3719,2817,264,2241,0,5322,Dodge8acef249c62a4e5f85501ad4ec76764d2a9f23ba38c41638b9e6f5d6678d3719
Montgomery,8acef249c62a4e5f85501ad4ec76764d2a9f23ba38c41638b9e6f5d6678d3719,1466,87,874,0,2427,Montgomery8acef249c62a4e5f85501ad4ec76764d2a9f23ba38c41638b9e6f5d6678d3719
Pulaski,8acef249c62a4e5f85501ad4ec76764d2a9f23ba38c41638b9e6f5d6678d3719,688,147,1900,1,2736,Pulaski8acef249c62a4e5f85501ad4ec76764d2a9f23ba38c41638b9e6f5d6678d3719
Telfair,8acef249c62a4e5f85501ad4ec76764d2a9f23ba38c41638b9e6f5d6678d3719,1530,151,1102,1,2784,Telfair8acef249c62a4e5f85501ad4ec76764d2a9f23ba38c41638b9e6f5d6678d3719
Wheeler,8acef249c62a4e5f85501ad4ec76764d2a9f23ba38c41638b9e6f5d6678d3719,725,114,684,3,1526,Wheeler8acef249c62a4e5f85501ad4ec76764d2a9f23ba38c41638b9e6f5d6678d3719
Bulloch,d2ae4e4122d0d87ce53ab8fcd9b9fcf865fbe181609a10dbbdbe7c244d961f75,9825,808,10104,44,20781,Bullochd2ae4e4122d0d87ce53ab8fcd9b9fcf865fbe181609a10dbbdbe7c244d961f75
Effingham,d2ae4e4122d0d87ce53ab8fcd9b9fcf865fbe181609a10dbbdbe7c244d961f75,9422,536,10269,8,20235,Effinghamd2ae4e4122d0d87ce53ab8fcd9b9fcf865fbe181609a10dbbdbe7c244d961f75
Jenkins,d2ae4e4122d0d87ce53ab8fcd9b9fcf865fbe181609a10dbbdbe7c244d961f75,940,129,1223,7,2299,Jenkinsd2ae4e4122d0d87ce53ab8fcd9b9fcf865fbe181609a10dbbdbe7c244d961f75
Screven,d2ae4e4122d0d87ce53ab8fcd9b9fcf865fbe181609a10dbbdbe7c244d961f75,2009,123,2079,0,4211,Screvend2ae4e4122d0d87ce53ab8fcd9b9fcf865fbe181609a10dbbdbe7c244d961f75
Clay,d4ec4371a9a09ca434e604c126c8e692b8e858694921a4baf7e5e3d26b015a60,437,82,470,3,992,Clayd4ec4371a9a09ca434e604c126c8e692b8e858694921a4baf7e5e3d26b015a60
Early,d4ec4371a9a09ca434e604c126c8e692b8e858694921a4baf7e5e3d26b015a60,1793,238,1738,0,3769,Earlyd4ec4371a9a09ca434e604c126c8e692b8e858694921a4baf7e5e3d26b015a60
Miller,d4ec4371a9a09ca434e604c126c8e692b8e858694921a4baf7e5e3d26b015a60,866,120,908,2,1896,Millerd4ec4371a9a09ca434e604c126c8e692b8e858694921a4baf7e5e3d26b015a60
Quitman,d4ec4371a9a09ca434e604c126c8e692b8e858694921a4baf7e5e3d26b015a60,349,30,313,0,692,Quitmand4ec4371a9a09ca434e604c126c8e692b8e858694921a4baf7e5e3d26b015a60
Seminole,d4ec4371a9a09ca434e604c126c8e692b8e858694921a4baf7e5e3d26b015a60,1618,136,1127,5,2886,Seminoled4ec4371a9a09ca434e604c126c8e692b8e858694921a4baf7e5e3d26b015a60
Terrell,d4ec4371a9a09ca434e604c126c8e692b8e858694921a4baf7e5e3d26b015a60,1466,207,1434,2,3109,Terrelld4ec4371a9a09ca434e604c126c8e692b8e858694921a4baf7e5e3d26b015a60
Banks,a51c9d982484bbbf017dfb879a70ddb3dd4f5658ec2cd4d8ffc8c9296d7b2a93,3142,184,2865,1,6192,Banksa51c9d982484bbbf017dfb879a70ddb3dd4f5658ec2cd4d8ffc8c9296d7b2a93
Barrow,a51c9d982484bbbf017dfb879a70ddb3dd4f5658ec2cd4d8ffc8c9296d7b2a93,10747,928,12874,1,24550,Barrowa51c9d982484bbbf017dfb879a70ddb3dd4f5658ec2cd4d8ffc8c9296d7b2a93
Jackson,a51c9d982484bbbf017dfb879a70ddb3dd4f5658ec2cd4d8ffc8c9296d7b2a93,8719,671,14577,35,24002,Jacksona51c9d982484bbbf017dfb879a70ddb3dd4f5658ec2cd4d8ffc8c9296d7b2a93
Floyd,855687623b913bdca5dcc190270c5c3cdc172ed0c60b74f638d445cf3c162e9f,9798,888,13452,74,24212,Floyd855687623b913bdca5dcc190270c5c3cdc172ed0c60b74f638d445cf3c162e9f
Floyd,bb8ff70f2e9ba51b9ede130d3ea3251bfcd76b6e2d37c9ffda2cc1378f99f7e4,3946,421,5040,27,9434,Floydbb8ff70f2e9ba51b9ede130d3ea3251bfcd76b6e2d37c9ffda2cc1378f99f7e4
Baker,58d60d58495b16c48cdc59e88a64ca9c5b9b926b0f8bcda16da4a82a25dd43cc,525,99,400,2,1026,Baker58d60d58495b16c48cdc59e88a64ca9c5b9b926b0f8bcda16da4a82a25dd43cc
Calhoun,58d60d58495b16c48cdc59e88a64ca9c5b9b926b0f8bcda16da4a82a25dd43cc,977,124,541,1,1643,Calhoun58d60d58495b16c48cdc59e88a64ca9c5b9b926b0f8bcda16da4a82a25dd43cc
Decatur,58d60d58495b16c48cdc59e88a64ca9c5b9b926b0f8bcda16da4a82a25dd43cc,3327,454,4572,24,8377,Decatur58d60d58495b16c48cdc59e88a64ca9c5b9b926b0f8bcda16da4a82a25dd43cc
Grady,58d60d58495b16c48cdc59e88a64ca9c5b9b926b0f8bcda16da4a82a25dd43cc,3003,222,3902,9,7136,Grady58d60d58495b16c48cdc59e88a64ca9c5b9b926b0f8bcda16da4a82a25dd43cc
Mitchell,58d60d58495b16c48cdc59e88a64ca9c5b9b926b0f8bcda16da4a82a25dd43cc,2968,503,3066,5,6542,Mitchell58d60d58495b16c48cdc59e88a64ca9c5b9b926b0f8bcda16da4a82a25dd43cc
Brooks,f7a909307363e9956b4933480e3841ac1995ad2c61b5157526403161cd71081f,2254,309,2207,38,4808,Brooksf7a909307363e9956b4933480e3841ac1995ad2c61b5157526403161cd71081f
Colquitt,f7a909307363e9956b4933480e3841ac1995ad2c61b5157526403161cd71081f,5682,360,5105,5,11152,Colquittf7a909307363e9956b4933480e3841ac1995ad2c61b5157526403161cd71081f
Echols,f7a909307363e9956b4933480e3841ac1995ad2c61b5157526403161cd71081f,419,37,585,0,1041,Echolsf7a909307363e9956b4933480e3841ac1995ad2c61b5157526403161cd71081f
Lowndes,f7a909307363e9956b4933480e3841ac1995ad2c61b5157526403161cd71081f,9187,1118,18743,385,29433,Lowndesf7a909307363e9956b4933480e3841ac1995ad2c61b5157526403161cd71081f
Thomas,f7a909307363e9956b4933480e3841ac1995ad2c61b5157526403161cd71081f,5563,627,8058,5,14253,Thomasf7a909307363e9956b4933480e3841ac1995ad2c61b5157526403161cd71081f
Lee,4abd4fdb43c4367a780838e25e9bfcaa5d5b6e97a4373f4d96e2c83af4c2708c,5756,405,6086,5,12252,Lee4abd4fdb43c4367a780838e25e9bfcaa5d5b6e97a4373f4d96e2c83af4c2708c
Macon,4abd4fdb43c4367a780838e25e9bfcaa5d5b6e97a4373f4d96e2c83af4c2708c,1078,135,1325,0,2538,Macon4abd4fdb43c4367a780838e25e9bfcaa5d5b6e97a4373f4d96e2c83af4c2708c
Schley,4abd4fdb43c4367a780838e25e9bfcaa5d5b6e97a4373f4d96e2c83af4c2708c,485,63,1031,0,1579,Schley4abd4fdb43c4367a780838e25e9bfcaa5d5b6e97a4373f4d96e2c83af4c2708c
Stewart,4abd4fdb43c4367a780838e25e9bfcaa5d5b6e97a4373f4d96e2c83af4c2708c,474,156,410,3,1043,Stewart4abd4fdb43c4367a780838e25e9bfcaa5d5b6e97a4373f4d96e2c83af4c2708c
Sumter,4abd4fdb43c4367a780838e25e9bfcaa5d5b6e97a4373f4d96e2c83af4c2708c,3405,529,4069,1,8004,Sumter4abd4fdb43c4367a780838e25e9bfcaa5d5b6e97a4373f4d96e2c83af4c2708c
Webster,4abd4fdb43c4367a780838e25e9bfcaa5d5b6e97a4373f4d96e2c83af4c2708c,341,75,340,0,756,Webster4abd4fdb43c4367a780838e25e9bfcaa5d5b6e97a4373f4d96e2c83af4c2708c
DeKalb,3f53560a4f65c89729ed4381453f440f11091381dc98657a5429bc9f9824e726,99884,11979,155534,427,267824,DeKalb3f53560a4f65c89729ed4381453f440f11091381dc98657a5429bc9f9824e726
Haralson,343e023ec6fe80c60e8e046e9ba15930b660152d14802d6f7b1c04e78f3fe571,5025,385,4668,7,10085,Haralson343e023ec6fe80c60e8e046e9ba15930b660152d14802d6f7b1c04e78f3fe571
Polk,343e023ec6fe80c60e8e046e9ba15930b660152d14802d6f7b1c04e78f3fe571,3816,400,7710,7,11933,Polk343e023ec6fe80c60e8e046e9ba15930b660152d14802d6f7b1c04e78f3fe571
Irwin,98c2bcf2d878241e9013cd4b72debaf3e9e0d67e217bab9501171e8a7151d242,1433,101,1503,5,3042,Irwin98c2bcf2d878241e9013cd4b72debaf3e9e0d67e217bab9501171e8a7151d242
Tift,98c2bcf2d878241e9013cd4b72debaf3e9e0d67e217bab9501171e8a7151d242,4554,430,6628,12,11624,Tift98c2bcf2d878241e9013cd4b72debaf3e9e0d67e217bab9501171e8a7151d242
Turner,98c2bcf2d878241e9013cd4b72debaf3e9e0d67e217bab9501171e8a7151d242,904,69,1658,3,2634,Turner98c2bcf2d878241e9013cd4b72debaf3e9e0d67e217bab9501171e8a7151d242
Worth,98c2bcf2d878241e9013cd4b72debaf3e9e0d67e217bab9501171e8a7151d242,3806,207,2870,9,6892,Worth98c2bcf2d878241e9013cd4b72debaf3e9e0d67e217bab9501171e8a7151d242
Glascock,03fad1d6eb8cf071d7bebe3c1e39dd542dd47c525b396019b6533d5ea6dc69a9,392,36,463,0,891,Glascock03fad1d6eb8cf071d7bebe3c1e39dd542dd47c525b396019b6533d5ea6dc69a9
Lincoln,03fad1d6eb8cf071d7bebe3c1e39dd542dd47c525b396019b6533d5ea6dc69a9,967,133,1277,0,2377,Lincoln03fad1d6eb8cf071d7bebe3c1e39dd542dd47c525b396019b6533d5ea6dc69a9
McDuffie,03fad1d6eb8cf071d7bebe3c1e39dd542dd47c525b396019b6533d5ea6dc69a9,1587,256,2436,0,4279,McDuffie03fad1d6eb8cf071d7bebe3c1e39dd542dd47c525b396019b6533d5ea6dc69a9
Taliaferro,03fad1d6eb8cf071d7bebe3c1e39dd542dd47c525b396019b6533d5ea6dc69a9,151,14,152,0,317,Taliaferro03fad1d6eb8cf071d7bebe3c1e39dd542dd47c525b396019b6533d5ea6dc69a9
Warren,03fad1d6eb8cf071d7bebe3c1e39dd542dd47c525b396019b6533d5ea6dc69a9,232,51,404,0,687,Warren03fad1d6eb8cf071d7bebe3c1e39dd542dd47c525b396019b6533d5ea6dc69a9
Wilkes,03fad1d6eb8cf071d7bebe3c1e39dd542dd47c525b396019b6533d5ea6dc69a9,725,62,724,2,1513,Wilkes03fad1d6eb8cf071d7bebe3c1e39dd542dd47c525b396019b6533d5ea6dc69a9
Glascock,071753766aed849b01c29196f8cc31a935a88896454a36e11f6d0db984ce0c05,164,33,168,0,365,Glascock071753766aed849b01c29196f8cc31a935a88896454a36e11f6d0db984ce0c05
Lincoln,071753766aed849b01c29196f8cc31a935a88896454a36e11f6d0db984ce0c05,551,244,736,1,1532,Lincoln071753766aed849b01c29196f8cc31a935a88896454a36e11f6d0db984ce0c05
McDuffie,071753766aed849b01c29196f8cc31a935a88896454a36e11f6d0db984ce0c05,1576,317,2625,0,4518,McDuffie071753766aed849b01c29196f8cc31a935a88896454a36e11f6d0db984ce0c05
Taliaferro,071753766aed849b01c29196f8cc31a935a88896454a36e11f6d0db984ce0c05,202,84,208,1,495,Taliaferro071753766aed849b01c29196f8cc31a935a88896454a36e11f6d0db984ce0c05
Warren,071753766aed849b01c29196f8cc31a935a88896454a36e11f6d0db984ce0c05,685,81,730,1,1497,Warren071753766aed849b01c29196f8cc31a935a88896454a36e11f6d0db984ce0c05
Wilkes,071753766aed849b01c29196f8cc31a935a88896454a36e11f6d0db984ce0c05,1300,117,1282,3,2702,Wilkes071753766aed849b01c29196f8cc31a935a88896454a36e11f6d0db984ce0c05
Clarke,60aa34d5909eec907f2bd237ef5d182ed83f01b718ec079cd3792c9048a325ed,15395,2100,19263,62,36820,Clarke60aa34d5909eec907f2bd237ef5d182ed83f01b718ec079cd3792c9048a325ed
Oconee,60aa34d5909eec907f2bd237ef5d182ed83f01b718ec079cd3792c9048a325ed,5605,623,8416,7,14651,Oconee60aa34d5909eec907f2bd237ef5d182ed83f01b718ec079cd3792c9048a325ed
Forsyth,03bee023cc3c4b88c302539b04555bc66d0508cf0103a2d6918c2d889adc7b5e,22508,3217,59447,34,85206,Forsyth03bee023cc3c4b88c302539b04555bc66d0508cf0103a2d6918c2d889adc7b5e
Butts,f6d5ccb36956b12451a3fb225e97ba7b76ed2b3b04adcbb0a18e572a4e4e3646,2161,223,5376,0,7760,Buttsf6d5ccb36956b12451a3fb225e97ba7b76ed2b3b04adcbb0a18e572a4e4e3646
Lamar,f6d5ccb36956b12451a3fb225e97ba7b76ed2b3b04adcbb0a18e572a4e4e3646,2415,258,3428,9,6110,Lamarf6d5ccb36956b12451a3fb225e97ba7b76ed2b3b04adcbb0a18e572a4e4e3646
Monroe,f6d5ccb36956b12451a3fb225e97ba7b76ed2b3b04adcbb0a18e572a4e4e3646,4848,381,5168,9,10406,Monroef6d5ccb36956b12451a3fb225e97ba7b76ed2b3b04adcbb0a18e572a4e4e3646
Appling,515162c3afcb80c00ecf30a60f627a376edac436b27381b042b69796d6266d3d,885,181,773,0,1839,Appling515162c3afcb80c00ecf30a60f627a376edac436b27381b042b69796d6266d3d
Atkinson,515162c3afcb80c00ecf30a60f627a376edac436b27381b042b69796d6266d3d,439,36,364,0,839,Atkinson515162c3afcb80c00ecf30a60f627a376edac436b27381b042b69796d6266d3d
Bacon,515162c3afcb80c00ecf30a60f627a376edac436b27381b042b69796d6266d3d,500,67,815,4,1386,Bacon515162c3afcb80c00ecf30a60f627a376edac436b27381b042b69796d6266d3d
Baker,515162c3afcb80c00ecf30a60f627a376edac436b27381b042b69796d6266d3d,243,61,211,0,515,Baker515162c3afcb80c00ecf30a60f627a376edac436b27381b042b69796d6266d3d
Baldwin,515162c3afcb80c00ecf30a60f627a376edac436b27381b042b69796d6266d3d,2295,343,3120,4,5762,Baldwin515162c3afcb80c00ecf30a60f627a376edac436b27381b042b69796d6266d3d
Banks,515162c3afcb80c00ecf30a60f627a376edac436b27381b042b69796d6266d3d,1226,87,1011,1,2325,Banks515162c3afcb80c00ecf30a60f627a376edac436b27381b042b69796d6266d3d
Barrow,515162c3afcb80c00ecf30a60f627a376edac436b27381b042b69796d6266d3d,4721,488,5685,0,10894,Barrow515162c3afcb80c00ecf30a60f627a376edac436b27381b042b69796d6266d3d
Bartow,515162c3afcb80c00ecf30a60f627a376edac436b27381b042b69796d6266d3d,7548,612,6567,12,14739,Bartow515162c3afcb80c00ecf30a60f627a376edac436b27381b042b69796d6266d3d
Ben Hill,515162c3afcb80c00ecf30a60f627a376edac436b27381b042b69796d6266d3d,485,81,1228,4,1798,Ben Hill515162c3afcb80c00ecf30a60f627a376edac436b27381b042b69796d6266d3d
Berrien,515162c3afcb80c00ecf30a60f627a376edac436b27381b042b69796d6266d3d,895,190,1151,10,2246,Berrien515162c3afcb80c00ecf30a60f627a376edac436b27381b042b69796d6266d3d
Bibb,515162c3afcb80c00ecf30a60f627a376edac436b27381b042b69796d6266d3d,11519,1533,10305,116,23473,Bibb515162c3afcb80c00ecf30a60f627a376edac436b27381b042b69796d6266d3d
Bleckley,515162c3afcb80c00ecf30a60f627a376edac436b27381b042b69796d6266d3d,607,87,785,2,1481,Bleckley515162c3afcb80c00ecf30a60f627a376edac436b27381b042b69796d6266d3d
Brantley,515162c3afcb80c00ecf30a60f627a376edac436b27381b042b69796d6266d3d,1068,90,1158,3,2319,Brantley515162c3afcb80c00ecf30a60f627a376edac436b27381b042b69796d6266d3d
Brooks,515162c3afcb80c00ecf30a60f627a376edac436b27381b042b69796d6266d3d,1245,273,1295,29,2842,Brooks515162c3afcb80c00ecf30a60f627a376edac436b27381b042b69796d6266d3d
Bryan,515162c3afcb80c00ecf30a60f627a376edac436b27381b042b69796d6266d3d,2510,274,3873,6,6663,Bryan515162c3afcb80c00ecf30a60f627a376edac436b27381b042b69796d6266d3d
Bulloch,515162c3afcb80c00ecf30a60f627a376edac436b27381b042b69796d6266d3d,4467,462,4917,28,9874,Bulloch515162c3afcb80c00ecf30a60f627a376edac436b27381b042b69796d6266d3d
Burke,515162c3afcb80c00ecf30a60f627a376edac436b27381b042b69796d6266d3d,1785,307,1312,0,3404,Burke515162c3afcb80c00ecf30a60f627a376edac436b27381b042b69796d6266d3d
Butts,515162c3afcb80c00ecf30a60f627a376edac436b27381b042b69796d6266d3d,1016,112,2359,0,3487,Butts515162c3afcb80c00ecf30a60f627a376edac436b27381b042b69796d6266d3d
Calhoun,515162c3afcb80c00ecf30a60f627a376edac436b27381b042b69796d6266d3d,304,49,197,1,551,Calhoun515162c3afcb80c00ecf30a60f627a376edac436b27381b042b69796d6266d3d
Camden,515162c3afcb80c00ecf30a60f627a376edac436b27381b042b69796d6266d3d,3747,657,5133,9,9546,Camden515162c3afcb80c00ecf30a60f627a376edac436b27381b042b69796d6266d3d
Candler,515162c3afcb80c00ecf30a60f627a376edac436b27381b042b69796d6266d3d,376,39,775,4,1194,Candler515162c3afcb80c00ecf30a60f627a376edac436b27381b042b69796d6266d3d
Carroll,515162c3afcb80c00ecf30a60f627a376edac436b27381b042b69796d6266d3d,6874,644,8406,47,15971,Carroll515162c3afcb80c00ecf30a60f627a376edac436b27381b042b69796d6266d3d
Catoosa,515162c3afcb80c00ecf30a60f627a376edac436b27381b042b69796d6266d3d,3762,356,7207,9,11334,Catoosa515162c3afcb80c00ecf30a60f627a376edac436b27381b042b69796d6266d3d
Charlton,515162c3afcb80c00ecf30a60f627a376edac436b27381b042b69796d6266d3d,706,107,891,4,1708,Charlton515162c3afcb80c00ecf30a60f627a376edac436b27381b042b69796d6266d3d
Chatham,515162c3afcb80c00ecf30a60f627a376edac436b27381b042b69796d6266d3d,26637,2294,12809,60,41800,Chatham515162c3afcb80c00ecf30a60f627a376edac436b27381b042b69796d6266d3d
Chattahoochee,515162c3afcb80c00ecf30a60f627a376edac436b27381b042b69796d6266d3d,360,36,334,4,734,Chattahoochee515162c3afcb80c00ecf30a60f627a376edac436b27381b042b69796d6266d3d
Chattooga,515162c3afcb80c00ecf30a60f627a376edac436b27381b042b69796d6266d3d,1151,87,1390,2,2630,Chattooga515162c3afcb80c00ecf30a60f627a376edac436b27381b042b69796d6266d3d
Cherokee,515162c3afcb80c00ecf30a60f627a376edac436b27381b042b69796d6266d3d,17979,2436,22644,11,43070,Cherokee515162c3afcb80c00ecf30a60f627a376edac436b27381b042b69796d6266d3d
Clarke,515162c3afcb80c00ecf30a60f627a376edac436b27381b042b69796d6266d3d,4737,861,4758,28,10384,Clarke515162c3afcb80c00ecf30a60f627a376edac436b27381b042b69796d6266d3d
Clay,515162c3afcb80c00ecf30a60f627a376edac436b27381b042b69796d6266d3d,191,42,272,2,507,Clay515162c3afcb80c00ecf30a60f627a376edac436b27381b042b69796d6266d3d
Clayton,515162c3afcb80c00ecf30a60f627a376edac436b27381b042b69796d6266d3d,14198,1478,19769,64,35509,Clayton515162c3afcb80c00ecf30a60f627a376edac436b27381b042b69796d6266d3d
Clinch,515162c3afcb80c00ecf30a60f627a376edac436b27381b042b69796d6266d3d,441,42,476,1,960,Clinch515162c3afcb80c00ecf30a60f627a376edac436b27381b042b69796d6266d3d
Cobb,515162c3afcb80c00ecf30a60f627a376edac436b27381b042b69796d6266d3d,67502,11021,54297,382,133202,Cobb515162c3afcb80c00ecf30a60f627a376edac436b27381b042b69796d6266d3d
Coffee,515162c3afcb80c00ecf30a60f627a376edac436b27381b042b69796d6266d3d,1736,198,3165,0,5099,Coffee515162c3afcb80c00ecf30a60f627a376edac436b27381b042b69796d6266d3d
Colquitt,515162c3afcb80c00ecf30a60f627a376edac436b27381b042b69796d6266d3d,1677,191,1775,5,3648,Colquitt515162c3afcb80c00ecf30a60f627a376edac436b27381b042b69796d6266d3d
Columbia,515162c3afcb80c00ecf30a60f627a376edac436b27381b042b69796d6266d3d,12806,1849,17677,16,32348,Columbia515162c3afcb80c00ecf30a60f627a376edac436b27381b042b69796d6266d3d
Cook,515162c3afcb80c00ecf30a60f627a376edac436b27381b042b69796d6266d3d,903,114,1264,0,2281,Cook515162c3afcb80c00ecf30a60f627a376edac436b27381b042b69796d6266d3d
Coweta,515162c3afcb80c00ecf30a60f627a376edac436b27381b042b69796d6266d3d,10929,1376,12539,10,24854,Coweta515162c3afcb80c00ecf30a60f627a376edac436b27381b042b69796d6266d3d
Crawford,515162c3afcb80c00ecf30a60f627a376edac436b27381b042b69796d6266d3d,850,102,995,2,1949,Crawford515162c3afcb80c00ecf30a60f627a376edac436b27381b042b69796d6266d3d
Crisp,515162c3afcb80c00ecf30a60f627a376edac436b27381b042b69796d6266d3d,969,158,1871,6,3004,Crisp515162c3afcb80c00ecf30a60f627a376edac436b27381b042b69796d6266d3d
Dade,515162c3afcb80c00ecf30a60f627a376edac436b27381b042b69796d6266d3d,1337,92,1286,1,2716,Dade515162c3afcb80c00ecf30a60f627a376edac436b27381b042b69796d6266d3d
Dawson,515162c3afcb80c00ecf30a60f627a376edac436b27381b042b69796d6266d3d,1210,262,2959,9,4440,Dawson515162c3afcb80c00ecf30a60f627a376edac436b27381b042b69796d6266d3d
Decatur,515162c3afcb80c00ecf30a60f627a376edac436b27381b042b69796d6266d3d,1634,235,2170,18,4057,Decatur515162c3afcb80c00ecf30a60f627a376edac436b27381b042b69796d6266d3d
DeKalb,515162c3afcb80c00ecf30a60f627a376edac436b27381b042b69796d6266d3d,46061,6937,57579,216,110793,DeKalb515162c3afcb80c00ecf30a60f627a376edac436b27381b042b69796d6266d3d
Dodge,515162c3afcb80c00ecf30a60f627a376edac436b27381b042b69796d6266d3d,1125,127,935,0,2187,Dodge515162c3afcb80c00ecf30a60f627a376edac436b27381b042b69796d6266d3d
Dooly,515162c3afcb80c00ecf30a60f627a376edac436b27381b042b69796d6266d3d,876,102,889,10,1877,Dooly515162c3afcb80c00ecf30a60f627a376edac436b27381b042b69796d6266d3d
Dougherty,515162c3afcb80c00ecf30a60f627a376edac436b27381b042b69796d6266d3d,5923,745,4863,41,11572,Dougherty515162c3afcb80c00ecf30a60f627a376edac436b27381b042b69796d6266d3d
Douglas,515162c3afcb80c00ecf30a60f627a376edac436b27381b042b69796d6266d3d,7829,1111,13421,21,22382,Douglas515162c3afcb80c00ecf30a60f627a376edac436b27381b042b69796d6266d3d
Early,515162c3afcb80c00ecf30a60f627a376edac436b27381b042b69796d6266d3d,783,138,733,1,1655,Early515162c3afcb80c00ecf30a60f627a376edac436b27381b042b69796d6266d3d
Echols,515162c3afcb80c00ecf30a60f627a376edac436b27381b042b69796d6266d3d,178,18,240,0,436,Echols515162c3afcb80c00ecf30a60f627a376edac436b27381b042b69796d6266d3d
Effingham,515162c3afcb80c00ecf30a60f627a376edac436b27381b042b69796d6266d3d,4453,318,4667,3,9441,Effingham515162c3afcb80c00ecf30a60f627a376edac436b27381b042b69796d6266d3d
Elbert,515162c3afcb80c00ecf30a60f627a376edac436b27381b042b69796d6266d3d,1106,217,1542,31,2896,Elbert515162c3afcb80c00ecf30a60f627a376edac436b27381b042b69796d6266d3d
Emanuel,515162c3afcb80c00ecf30a60f627a376edac436b27381b042b69796d6266d3d,1469,115,1187,3,2774,Emanuel515162c3afcb80c00ecf30a60f627a376edac436b27381b042b69796d6266d3d
Evans,515162c3afcb80c00ecf30a60f627a376edac436b27381b042b69796d6266d3d,441,70,840,0,1351,Evans515162c3afcb80c00ecf30a60f627a376edac436b27381b042b69796d6266d3d
Fannin,515162c3afcb80c00ecf30a60f627a376edac436b27381b042b69796d6266d3d,1426,294,1966,3,3689,Fannin515162c3afcb80c00ecf30a60f627a376edac436b27381b042b69796d6266d3d
Fayette,515162c3afcb80c00ecf30a60f627a376edac436b27381b042b69796d6266d3d,7744,1407,15887,10,25048,Fayette515162c3afcb80c00ecf30a60f627a376edac436b27381b042b69796d6266d3d
Floyd,515162c3afcb80c00ecf30a60f627a376edac436b27381b042b69796d6266d3d,4257,530,5488,42,10317,Floyd515162c3afcb80c00ecf30a60f627a376edac436b27381b042b69796d6266d3d
Forsyth,515162c3afcb80c00ecf30a60f627a376edac436b27381b042b69796d6266d3d,12700,2166,31443,26,46335,Forsyth515162c3afcb80c00ecf30a60f627a376edac436b27381b042b69796d6266d3d
Franklin,515162c3afcb80c00ecf30a60f627a376edac436b27381b042b69796d6266d3d,1547,190,1449,0,3186,Franklin515162c3afcb80c00ecf30a60f627a376edac436b27381b042b69796d6266d3d
Fulton,515162c3afcb80c00ecf30a60f627a376edac436b27381b042b69796d6266d3d,67025,10505,108171,602,186303,Fulton515162c3afcb80c00ecf30a60f627a376edac436b27381b042b69796d6266d3d
Gilmer,515162c3afcb80c00ecf30a60f627a376edac436b27381b042b69796d6266d3d,1703,291,2464,6,4464,Gilmer515162c3afcb80c00ecf30a60f627a376edac436b27381b042b69796d6266d3d
Glascock,515162c3afcb80c00ecf30a60f627a376edac436b27381b042b69796d6266d3d,214,23,242,0,479,Glascock515162c3afcb80c00ecf30a60f627a376edac436b27381b042b69796d6266d3d
Glynn,515162c3afcb80c00ecf30a60f627a376edac436b27381b042b69796d6266d3d,6101,755,8072,31,14959,Glynn515162c3afcb80c00ecf30a60f627a376edac436b27381b042b69796d6266d3d
Gordon,515162c3afcb80c00ecf30a60f627a376edac436b27381b042b69796d6266d3d,2817,236,3293,14,6360,Gordon515162c3afcb80c00ecf30a60f627a376edac436b27381b042b69796d6266d3d
Grady,515162c3afcb80c00ecf30a60f627a376edac436b27381b042b69796d6266d3d,1474,131,2030,5,3640,Grady515162c3afcb80c00ecf30a60f627a376edac436b27381b042b69796d6266d3d
Greene,515162c3afcb80c00ecf30a60f627a376edac436b27381b042b69796d6266d3d,1211,287,2851,2,4351,Greene515162c3afcb80c00ecf30a60f627a376edac436b27381b042b69796d6266d3d
Gwinnett,515162c3afcb80c00ecf30a60f627a376edac436b27381b042b69796d6266d3d,73241,8965,62827,827,145860,Gwinnett515162c3afcb80c00ecf30a60f627a376edac436b27381b042b69796d6266d3d
Habersham,515162c3afcb80c00ecf30a60f627a376edac436b27381b042b69796d6266d3d,1395,402,4025,2,5824,Habersham515162c3afcb80c00ecf30a60f627a376edac436b27381b042b69796d6266d3d
Hall,515162c3afcb80c00ecf30a60f627a376edac436b27381b042b69796d6266d3d,13245,1692,14469,30,29436,Hall515162c3afcb80c00ecf30a60f627a376edac436b27381b042b69796d6266d3d
Hancock,515162c3afcb80c00ecf30a60f627a376edac436b27381b042b69796d6266d3d,669,98,534,3,1304,Hancock515162c3afcb80c00ecf30a60f627a376edac436b27381b042b69796d6266d3d
Haralson,515162c3afcb80c00ecf30a60f627a376edac436b27381b042b69796d6266d3d,1595,200,1485,1,3281,Haralson515162c3afcb80c00ecf30a60f627a376edac436b27381b042b69796d6266d3d
Harris,515162c3afcb80c00ecf30a60f627a376edac436b27381b042b69796d6266d3d,3102,356,4073,0,7531,Harris515162c3afcb80c00ecf30a60f627a376edac436b27381b042b69796d6266d3d
Hart,515162c3afcb80c00ecf30a60f627a376edac436b27381b042b69796d6266d3d,1587,216,2052,1,3856,Hart515162c3afcb80c00ecf30a60f627a376edac436b27381b042b69796d6266d3d
Heard,515162c3afcb80c00ecf30a60f627a376edac436b27381b042b69796d6266d3d,737,116,609,1,1463,Heard515162c3afcb80c00ecf30a60f627a376edac436b27381b042b69796d6266d3d
Henry,515162c3afcb80c00ecf30a60f627a376edac436b27381b042b69796d6266d3d,11288,1707,25475,85,38555,Henry515162c3afcb80c00ecf30a60f627a376edac436b27381b042b69796d6266d3d
Houston,515162c3afcb80c00ecf30a60f627a376edac436b27381b042b69796d6266d3d,7982,1193,13544,79,22798,Houston515162c3afcb80c00ecf30a60f627a376edac436b27381b042b69796d6266d3d
Irwin,515162c3afcb80c00ecf30a60f627a376edac436b27381b042b69796d6266d3d,379,48,530,3,960,Irwin515162c3afcb80c00ecf30a60f627a376edac436b27381b042b69796d6266d3d
Jackson,515162c3afcb80c00ecf30a60f627a376edac436b27381b042b69796d6266d3d,3535,332,5419,25,9311,Jackson515162c3afcb80c00ecf30a60f627a376edac436b27381b042b69796d6266d3d
Jasper,515162c3afcb80c00ecf30a60f627a376edac436b27381b042b69796d6266d3d,861,140,1105,3,2109,Jasper515162c3afcb80c00ecf30a60f627a376edac436b27381b042b69796d6266d3d
Jeff Davis,515162c3afcb80c00ecf30a60f627a376edac436b27381b042b69796d6266d3d,685,56,725,2,1468,Jeff Davis515162c3afcb80c00ecf30a60f627a376edac436b27381b042b69796d6266d3d
Jefferson,515162c3afcb80c00ecf30a60f627a376edac436b27381b042b69796d6266d3d,1190,180,943,9,2322,Jefferson515162c3afcb80c00ecf30a60f627a376edac436b27381b042b69796d6266d3d
Jenkins,515162c3afcb80c00ecf30a60f627a376edac436b27381b042b69796d6266d3d,494,89,594,7,1184,Jenkins515162c3afcb80c00ecf30a60f627a376edac436b27381b042b69796d6266d3d
Johnson,515162c3afcb80c00ecf30a60f627a376edac436b27381b042b69796d6266d3d,408,92,483,0,983,Johnson515162c3afcb80c00ecf30a60f627a376edac436b27381b042b69796d6266d3d
Jones,515162c3afcb80c00ecf30a60f627a376edac436b27381b042b69796d6266d3d,1546,295,2126,0,3967,Jones515162c3afcb80c00ecf30a60f627a376edac436b27381b042b69796d6266d3d
Lamar,515162c3afcb80c00ecf30a60f627a376edac436b27381b042b69796d6266d3d,940,138,1398,5,2481,Lamar515162c3afcb80c00ecf30a60f627a376edac436b27381b042b69796d6266d3d
Lanier,515162c3afcb80c00ecf30a60f627a376edac436b27381b042b69796d6266d3d,509,37,721,1,1268,Lanier515162c3afcb80c00ecf30a60f627a376edac436b27381b042b69796d6266d3d
Laurens,515162c3afcb80c00ecf30a60f627a376edac436b27381b042b69796d6266d3d,2577,404,2376,2,5359,Laurens515162c3afcb80c00ecf30a60f627a376edac436b27381b042b69796d6266d3d
Lee,515162c3afcb80c00ecf30a60f627a376edac436b27381b042b69796d6266d3d,2399,250,2807,3,5459,Lee515162c3afcb80c00ecf30a60f627a376edac436b27381b042b69796d6266d3d
Liberty,515162c3afcb80c00ecf30a60f627a376edac436b27381b042b69796d6266d3d,3097,314,4313,24,7748,Liberty515162c3afcb80c00ecf30a60f627a376edac436b27381b042b69796d6266d3d
Lincoln,515162c3afcb80c00ecf30a60f627a376edac436b27381b042b69796d6266d3d,625,139,772,1,1537,Lincoln515162c3afcb80c00ecf30a60f627a376edac436b27381b042b69796d6266d3d
Long,515162c3afcb80c00ecf30a60f627a376edac436b27381b042b69796d6266d3d,774,40,744,4,1562,Long515162c3afcb80c00ecf30a60f627a376edac436b27381b042b69796d6266d3d
Lowndes,515162c3afcb80c00ecf30a60f627a376edac436b27381b042b69796d6266d3d,5277,811,10539,305,16932,Lowndes515162c3afcb80c00ecf30a60f627a376edac436b27381b042b69796d6266d3d
Lumpkin,515162c3afcb80c00ecf30a60f627a376edac436b27381b042b69796d6266d3d,1127,207,2971,1,4306,Lumpkin515162c3afcb80c00ecf30a60f627a376edac436b27381b042b69796d6266d3d
Macon,515162c3afcb80c00ecf30a60f627a376edac436b27381b042b69796d6266d3d,749,120,843,0,1712,Macon515162c3afcb80c00ecf30a60f627a376edac436b27381b042b69796d6266d3d
Madison,515162c3afcb80c00ecf30a60f627a376edac436b27381b042b69796d6266d3d,1335,164,1496,4,2999,Madison515162c3afcb80c00ecf30a60f627a376edac436b27381b042b69796d6266d3d
Marion,515162c3afcb80c00ecf30a60f627a376edac436b27381b042b69796d6266d3d,637,111,561,0,1309,Marion515162c3afcb80c00ecf30a60f627a376edac436b27381b042b69796d6266d3d
McDuffie,515162c3afcb80c00ecf30a60f627a376edac436b27381b042b69796d6266d3d,1461,280,2005,0,3746,McDuffie515162c3afcb80c00ecf30a60f627a376edac436b27381b042b69796d6266d3d
McIntosh,515162c3afcb80c00ecf30a60f627a376edac436b27381b042b69796d6266d3d,948,254,1300,6,2508,McIntosh515162c3afcb80c00ecf30a60f627a376edac436b27381b042b69796d6266d3d
Meriwether,515162c3afcb80c00ecf30a60f627a376edac436b27381b042b69796d6266d3d,1934,181,1246,2,3363,Meriwether515162c3afcb80c00ecf30a60f627a376edac436b27381b042b69796d6266d3d
Miller,515162c3afcb80c00ecf30a60f627a376edac436b27381b042b69796d6266d3d,401,57,403,1,862,Miller515162c3afcb80c00ecf30a60f627a376edac436b27381b042b69796d6266d3d
Mitchell,515162c3afcb80c00ecf30a60f627a376edac436b27381b042b69796d6266d3d,1024,211,1335,4,2574,Mitchell515162c3afcb80c00ecf30a60f627a376edac436b27381b042b69796d6266d3d
Monroe,515162c3afcb80c00ecf30a60f627a376edac436b27381b042b69796d6266d3d,2114,225,2394,4,4737,Monroe515162c3afcb80c00ecf30a60f627a376edac436b27381b042b69796d6266d3d
Montgomery,515162c3afcb80c00ecf30a60f627a376edac436b27381b042b69796d6266d3d,594,51,407,0,1052,Montgomery515162c3afcb80c00ecf30a60f627a376edac436b27381b042b69796d6266d3d
Morgan,515162c3afcb80c00ecf30a60f627a376edac436b27381b042b69796d6266d3d,1179,148,1853,1,3181,Morgan515162c3afcb80c00ecf30a60f627a376edac436b27381b042b69796d6266d3d
Murray,515162c3afcb80c00ecf30a60f627a376edac436b27381b042b69796d6266d3d,2205,164,1989,0,4358,Murray515162c3afcb80c00ecf30a60f627a376edac436b27381b042b69796d6266d3d
Muscogee,515162c3afcb80c00ecf30a60f627a376edac436b27381b042b69796d6266d3d,15991,2059,16360,70,34480,Muscogee515162c3afcb80c00ecf30a60f627a376edac436b27381b042b69796d6266d3d
Newton,515162c3afcb80c00ecf30a60f627a376edac436b27381b042b69796d6266d3d,7448,845,7797,2,16092,Newton515162c3afcb80c00ecf30a60f627a376edac436b27381b042b69796d6266d3d
Oconee,515162c3afcb80c00ecf30a60f627a376edac436b27381b042b69796d6266d3d,2254,348,3331,2,5935,Oconee515162c3afcb80c00ecf30a60f627a376edac436b27381b042b69796d6266d3d
Oglethorpe,515162c3afcb80c00ecf30a60f627a376edac436b27381b042b69796d6266d3d,576,136,935,2,1649,Oglethorpe515162c3afcb80c00ecf30a60f627a376edac436b27381b042b69796d6266d3d
Paulding,515162c3afcb80c00ecf30a60f627a376edac436b27381b042b69796d6266d3d,7431,1407,15876,17,24731,Paulding515162c3afcb80c00ecf30a60f627a376edac436b27381b042b69796d6266d3d
Peach,515162c3afcb80c00ecf30a60f627a376edac436b27381b042b69796d6266d3d,1454,162,2859,12,4487,Peach515162c3afcb80c00ecf30a60f627a376edac436b27381b042b69796d6266d3d
Pickens,515162c3afcb80c00ecf30a60f627a376edac436b27381b042b69796d6266d3d,1897,121,2991,1,5010,Pickens515162c3afcb80c00ecf30a60f627a376edac436b27381b042b69796d6266d3d
Pierce,515162c3afcb80c00ecf30a60f627a376edac436b27381b042b69796d6266d3d,647,131,1312,0,2090,Pierce515162c3afcb80c00ecf30a60f627a376edac436b27381b042b69796d6266d3d
Pike,515162c3afcb80c00ecf30a60f627a376edac436b27381b042b69796d6266d3d,1106,143,1718,3,2970,Pike515162c3afcb80c00ecf30a60f627a376edac436b27381b042b69796d6266d3d
Polk,515162c3afcb80c00ecf30a60f627a376edac436b27381b042b69796d6266d3d,1475,165,2760,3,4403,Polk515162c3afcb80c00ecf30a60f627a376edac436b27381b042b69796d6266d3d
Pulaski,515162c3afcb80c00ecf30a60f627a376edac436b27381b042b69796d6266d3d,373,70,866,1,1310,Pulaski515162c3afcb80c00ecf30a60f627a376edac436b27381b042b69796d6266d3d
Putnam,515162c3afcb80c00ecf30a60f627a376edac436b27381b042b69796d6266d3d,1341,266,1944,4,3555,Putnam515162c3afcb80c00ecf30a60f627a376edac436b27381b042b69796d6266d3d
Quitman,515162c3afcb80c00ecf30a60f627a376edac436b27381b042b69796d6266d3d,198,39,238,0,475,Quitman515162c3afcb80c00ecf30a60f627a376edac436b27381b042b69796d6266d3d
Rabun,515162c3afcb80c00ecf30a60f627a376edac436b27381b042b69796d6266d3d,560,425,2031,0,3016,Rabun515162c3afcb80c00ecf30a60f627a376edac436b27381b042b69796d6266d3d
Randolph,515162c3afcb80c00ecf30a60f627a376edac436b27381b042b69796d6266d3d,676,113,655,1,1445,Randolph515162c3afcb80c00ecf30a60f627a376edac436b27381b042b69796d6266d3d
Richmond,515162c3afcb80c00ecf30a60f627a376edac436b27381b042b69796d6266d3d,16243,2154,14372,57,32826,Richmond515162c3afcb80c00ecf30a60f627a376edac436b27381b042b69796d6266d3d
Rockdale,515162c3afcb80c00ecf30a60f627a376edac436b27381b042b69796d6266d3d,4287,725,9145,16,14173,Rockdale515162c3afcb80c00ecf30a60f627a376edac436b27381b042b69796d6266d3d
Schley,515162c3afcb80c00ecf30a60f627a376edac436b27381b042b69796d6266d3d,210,26,377,0,613,Schley515162c3afcb80c00ecf30a60f627a376edac436b27381b042b69796d6266d3d
Screven,515162c3afcb80c00ecf30a60f627a376edac436b27381b042b69796d6266d3d,1082,87,952,0,2121,Screven515162c3afcb80c00ecf30a60f627a376edac436b27381b042b69796d6266d3d
Seminole,515162c3afcb80c00ecf30a60f627a376edac436b27381b042b69796d6266d3d,698,75,570,2,1345,Seminole515162c3afcb80c00ecf30a60f627a376edac436b27381b042b69796d6266d3d
Spalding,515162c3afcb80c00ecf30a60f627a376edac436b27381b042b69796d6266d3d,3849,445,5493,6,9793,Spalding515162c3afcb80c00ecf30a60f627a376edac436b27381b042b69796d6266d3d
Stephens,515162c3afcb80c00ecf30a60f627a376edac436b27381b042b69796d6266d3d,921,277,2459,2,3659,Stephens515162c3afcb80c00ecf30a60f627a376edac436b27381b042b69796d6266d3d
Stewart,515162c3afcb80c00ecf30a60f627a376edac436b27381b042b69796d6266d3d,372,157,376,2,907,Stewart515162c3afcb80c00ecf30a60f627a376edac436b27381b042b69796d6266d3d
Sumter,515162c3afcb80c00ecf30a60f627a376edac436b27381b042b69796d6266d3d,1560,276,2167,0,4003,Sumter515162c3afcb80c00ecf30a60f627a376edac436b27381b042b69796d6266d3d
Talbot,515162c3afcb80c00ecf30a60f627a376edac436b27381b042b69796d6266d3d,817,290,373,0,1480,Talbot515162c3afcb80c00ecf30a60f627a376edac436b27381b042b69796d6266d3d
Taliaferro,515162c3afcb80c00ecf30a60f627a376edac436b27381b042b69796d6266d3d,170,47,151,0,368,Taliaferro515162c3afcb80c00ecf30a60f627a376edac436b27381b042b69796d6266d3d
Tattnall,515162c3afcb80c00ecf30a60f627a376edac436b27381b042b69796d6266d3d,910,190,1147,4,2251,Tattnall515162c3afcb80c00ecf30a60f627a376edac436b27381b042b69796d6266d3d
Taylor,515162c3afcb80c00ecf30a60f627a376edac436b27381b042b69796d6266d3d,519,125,539,0,1183,Taylor515162c3afcb80c00ecf30a60f627a376edac436b27381b042b69796d6266d3d
Telfair,515162c3afcb80c00ecf30a60f627a376edac436b27381b042b69796d6266d3d,622,54,374,0,1050,Telfair515162c3afcb80c00ecf30a60f627a376edac436b27381b042b69796d6266d3d
Terrell,515162c3afcb80c00ecf30a60f627a376edac436b27381b042b69796d6266d3d,736,127,744,2,1609,Terrell515162c3afcb80c00ecf30a60f627a376edac436b27381b042b69796d6266d3d
Thomas,515162c3afcb80c00ecf30a60f627a376edac436b27381b042b69796d6266d3d,3176,439,4504,4,8123,Thomas515162c3afcb80c00ecf30a60f627a376edac436b27381b042b69796d6266d3d
Tift,515162c3afcb80c00ecf30a60f627a376edac436b27381b042b69796d6266d3d,1868,280,3026,9,5183,Tift515162c3afcb80c00ecf30a60f627a376edac436b27381b042b69796d6266d3d
Toombs,515162c3afcb80c00ecf30a60f627a376edac436b27381b042b69796d6266d3d,1251,231,1509,0,2991,Toombs515162c3afcb80c00ecf30a60f627a376edac436b27381b042b69796d6266d3d
Towns,515162c3afcb80c00ecf30a60f627a376edac436b27381b042b69796d6266d3d,729,178,1872,5,2784,Towns515162c3afcb80c00ecf30a60f627a376edac436b27381b042b69796d6266d3d
Treutlen,515162c3afcb80c00ecf30a60f627a376edac436b27381b042b69796d6266d3d,289,59,523,1,872,Treutlen515162c3afcb80c00ecf30a60f627a376edac436b27381b042b69796d6266d3d
Troup,515162c3afcb80c00ecf30a60f627a376edac436b27381b042b69796d6266d3d,4641,563,4477,125,9806,Troup515162c3afcb80c00ecf30a60f627a376edac436b27381b042b69796d6266d3d
Turner,515162c3afcb80c00ecf30a60f627a376edac436b27381b042b69796d6266d3d,448,32,732,4,1216,Turner515162c3afcb80c00ecf30a60f627a376edac436b27381b042b69796d6266d3d
Twiggs,515162c3afcb80c00ecf30a60f627a376edac436b27381b042b69796d6266d3d,797,130,541,1,1469,Twiggs515162c3afcb80c00ecf30a60f627a376edac436b27381b042b69796d6266d3d
Union,515162c3afcb80c00ecf30a60f627a376edac436b27381b042b69796d6266d3d,1306,285,2750,0,4341,Union515162c3afcb80c00ecf30a60f627a376edac436b27381b042b69796d6266d3d
Upson,515162c3afcb80c00ecf30a60f627a376edac436b27381b042b69796d6266d3d,1174,182,2653,0,4009,Upson515162c3afcb80c00ecf30a60f627a376edac436b27381b042b69796d6266d3d
Walker,515162c3afcb80c00ecf30a60f627a376edac436b27381b042b69796d6266d3d,3897,470,4759,5,9131,Walker515162c3afcb80c00ecf30a60f627a376edac436b27381b042b69796d6266d3d
Walton,515162c3afcb80c00ecf30a60f627a376edac436b27381b042b69796d6266d3d,8082,752,7185,15,16034,Walton515162c3afcb80c00ecf30a60f627a376edac436b27381b042b69796d6266d3d
Ware,515162c3afcb80c00ecf30a60f627a376edac436b27381b042b69796d6266d3d,1614,243,2260,1,4118,Ware515162c3afcb80c00ecf30a60f627a376edac436b27381b042b69796d6266d3d
Warren,515162c3afcb80c00ecf30a60f627a376edac436b27381b042b69796d6266d3d,378,58,451,0,887,Warren515162c3afcb80c00ecf30a60f627a376edac436b27381b042b69796d6266d3d
Washington,515162c3afcb80c00ecf30a60f627a376edac436b27381b042b69796d6266d3d,1057,258,1132,5,2452,Washington515162c3afcb80c00ecf30a60f627a376edac436b27381b042b69796d6266d3d
Wayne,515162c3afcb80c00ecf30a60f627a376edac436b27381b042b69796d6266d3d,1491,158,1762,8,3419,Wayne515162c3afcb80c00ecf30a60f627a376edac436b27381b042b69796d6266d3d
Webster,515162c3afcb80c00ecf30a60f627a376edac436b27381b042b69796d6266d3d,179,53,174,0,406,Webster515162c3afcb80c00ecf30a60f627a376edac436b27381b042b69796d6266d3d
Wheeler,515162c3afcb80c00ecf30a60f627a376edac436b27381b042b69796d6266d3d,298,59,291,2,650,Wheeler515162c3afcb80c00ecf30a60f627a376edac436b27381b042b69796d6266d3d
White,515162c3afcb80c00ecf30a60f627a376edac436b27381b042b69796d6266d3d,1646,280,2255,5,4186,White515162c3afcb80c00ecf30a60f627a376edac436b27381b042b69796d6266d3d
Whitfield,515162c3afcb80c00ecf30a60f627a376edac436b27381b042b69796d6266d3d,5773,527,4898,9,11207,Whitfield515162c3afcb80c00ecf30a60f627a376edac436b27381b042b69796d6266d3d
Wilcox,515162c3afcb80c00ecf30a60f627a376edac436b27381b042b69796d6266d3d,448,81,340,0,869,Wilcox515162c3afcb80c00ecf30a60f627a376edac436b27381b042b69796d6266d3d
Wilkes,515162c3afcb80c00ecf30a60f627a376edac436b27381b042b69796d6266d3d,670,75,690,5,1440,Wilkes515162c3afcb80c00ecf30a60f627a376edac436b27381b042b69796d6266d3d
Wilkinson,515162c3afcb80c00ecf30a60f627a376edac436b27381b042b69796d6266d3d,811,88,485,0,1384,Wilkinson515162c3afcb80c00ecf30a60f627a376edac436b27381b042b69796d6266d3d
Worth,515162c3afcb80c00ecf30a60f627a376edac436b27381b042b69796d6266d3d,1290,109,1227,6,2632,Worth515162c3afcb80c00ecf30a60f627a376edac436b27381b042b69796d6266d3d
Appling,a53022b8da673083a6f08004af93a13a519055233cf8d064e45a105eb6055d4d,2645,327,1906,2,4880,Applinga53022b8da673083a6f08004af93a13a519055233cf8d064e45a105eb6055d4d
Atkinson,a53022b8da673083a6f08004af93a13a519055233cf8d064e45a105eb6055d4d,698,50,842,1,1591,Atkinsona53022b8da673083a6f08004af93a13a519055233cf8d064e45a105eb6055d4d
Bacon,a53022b8da673083a6f08004af93a13a519055233cf8d064e45a105eb6055d4d,857,92,1447,1,2397,Bacona53022b8da673083a6f08004af93a13a519055233cf8d064e45a105eb6055d4d
Baker,a53022b8da673083a6f08004af93a13a519055233cf8d064e45a105eb6055d4d,450,77,317,2,846,Bakera53022b8da673083a6f08004af93a13a519055233cf8d064e45a105eb6055d4d
Baldwin,a53022b8da673083a6f08004af93a13a519055233cf8d064e45a105eb6055d4d,3858,705,5437,4,10004,Baldwina53022b8da673083a6f08004af93a13a519055233cf8d064e45a105eb6055d4d
Banks,a53022b8da673083a6f08004af93a13a519055233cf8d064e45a105eb6055d4d,2225,147,2136,0,4508,Banksa53022b8da673083a6f08004af93a13a519055233cf8d064e45a105eb6055d4d
Barrow,a53022b8da673083a6f08004af93a13a519055233cf8d064e45a105eb6055d4d,7558,660,9372,1,17591,Barrowa53022b8da673083a6f08004af93a13a519055233cf8d064e45a105eb6055d4d
Bartow,a53022b8da673083a6f08004af93a13a519055233cf8d064e45a105eb6055d4d,12657,846,10614,13,24130,Bartowa53022b8da673083a6f08004af93a13a519055233cf8d064e45a105eb6055d4d
Ben Hill,a53022b8da673083a6f08004af93a13a519055233cf8d064e45a105eb6055d4d,1080,153,2702,4,3939,Ben Hilla53022b8da673083a6f08004af93a13a519055233cf8d064e45a105eb6055d4d
Berrien,a53022b8da673083a6f08004af93a13a519055233cf8d064e45a105eb6055d4d,1945,164,2030,7,4146,Berriena53022b8da673083a6f08004af93a13a519055233cf8d064e45a105eb6055d4d
Bibb,a53022b8da673083a6f08004af93a13a519055233cf8d064e45a105eb6055d4d,17337,2088,17534,91,37050,Bibba53022b8da673083a6f08004af93a13a519055233cf8d064e45a105eb6055d4d
Bleckley,a53022b8da673083a6f08004af93a13a519055233cf8d064e45a105eb6055d4d,1410,148,1816,3,3377,Bleckleya53022b8da673083a6f08004af93a13a519055233cf8d064e45a105eb6055d4d
Brantley,a53022b8da673083a6f08004af93a13a519055233cf8d064e45a105eb6055d4d,1700,135,1836,3,3674,Brantleya53022b8da673083a6f08004af93a13a519055233cf8d064e45a105eb6055d4d
Brooks,a53022b8da673083a6f08004af93a13a519055233cf8d064e45a105eb6055d4d,1442,296,1338,16,3092,Brooksa53022b8da673083a6f08004af93a13a519055233cf8d064e45a105eb6055d4d
Bryan,a53022b8da673083a6f08004af93a13a519055233cf8d064e45a105eb6055d4d,3028,246,4858,2,8134,Bryana53022b8da673083a6f08004af93a13a519055233cf8d064e45a105eb6055d4d
Bulloch,a53022b8da673083a6f08004af93a13a519055233cf8d064e45a105eb6055d4d,7121,543,7268,19,14951,Bullocha53022b8da673083a6f08004af93a13a519055233cf8d064e45a105eb6055d4d
Burke,a53022b8da673083a6f08004af93a13a519055233cf8d064e45a105eb6055d4d,2892,593,2228,0,5713,Burkea53022b8da673083a6f08004af93a13a519055233cf8d064e45a105eb6055d4d
Butts,a53022b8da673083a6f08004af93a13a519055233cf8d064e45a105eb6055d4d,1579,160,4025,0,5764,Buttsa53022b8da673083a6f08004af93a13a519055233cf8d064e45a105eb6055d4d
Calhoun,a53022b8da673083a6f08004af93a13a519055233cf8d064e45a105eb6055d4d,887,98,455,0,1440,Calhouna53022b8da673083a6f08004af93a13a519055233cf8d064e45a105eb6055d4d
Camden,a53022b8da673083a6f08004af93a13a519055233cf8d064e45a105eb6055d4d,3362,419,4972,8,8761,Camdena53022b8da673083a6f08004af93a13a519055233cf8d064e45a105eb6055d4d
Candler,a53022b8da673083a6f08004af93a13a519055233cf8d064e45a105eb6055d4d,583,93,1793,1,2470,Candlera53022b8da673083a6f08004af93a13a519055233cf8d064e45a105eb6055d4d
Carroll,a53022b8da673083a6f08004af93a13a519055233cf8d064e45a105eb6055d4d,11757,790,14888,32,27467,Carrolla53022b8da673083a6f08004af93a13a519055233cf8d064e45a105eb6055d4d
Catoosa,a53022b8da673083a6f08004af93a13a519055233cf8d064e45a105eb6055d4d,5103,289,9176,3,14571,Catoosaa53022b8da673083a6f08004af93a13a519055233cf8d064e45a105eb6055d4d
Charlton,a53022b8da673083a6f08004af93a13a519055233cf8d064e45a105eb6055d4d,865,92,1090,2,2049,Charltona53022b8da673083a6f08004af93a13a519055233cf8d064e45a105eb6055d4d
Chatham,a53022b8da673083a6f08004af93a13a519055233cf8d064e45a105eb6055d4d,44054,2596,22111,48,68809,Chathama53022b8da673083a6f08004af93a13a519055233cf8d064e45a105eb6055d4d
Chattahoochee,a53022b8da673083a6f08004af93a13a519055233cf8d064e45a105eb6055d4d,327,9,223,2,561,Chattahoocheea53022b8da673083a6f08004af93a13a519055233cf8d064e45a105eb6055d4d
Chattooga,a53022b8da673083a6f08004af93a13a519055233cf8d064e45a105eb6055d4d,2565,131,2650,3,5349,Chattoogaa53022b8da673083a6f08004af93a13a519055233cf8d064e45a105eb6055d4d
Cherokee,a53022b8da673083a6f08004af93a13a519055233cf8d064e45a105eb6055d4d,26668,2751,37657,13,67089,Cherokeea53022b8da673083a6f08004af93a13a519055233cf8d064e45a105eb6055d4d
Clarke,a53022b8da673083a6f08004af93a13a519055233cf8d064e45a105eb6055d4d,14132,1678,18044,55,33909,Clarkea53022b8da673083a6f08004af93a13a519055233cf8d064e45a105eb6055d4d
Clay,a53022b8da673083a6f08004af93a13a519055233cf8d064e45a105eb6055d4d,319,54,331,1,705,Claya53022b8da673083a6f08004af93a13a519055233cf8d064e45a105eb6055d4d
Clayton,a53022b8da673083a6f08004af93a13a519055233cf8d064e45a105eb6055d4d,18957,1460,35283,80,55780,Claytona53022b8da673083a6f08004af93a13a519055233cf8d064e45a105eb6055d4d
Clinch,a53022b8da673083a6f08004af93a13a519055233cf8d064e45a105eb6055d4d,495,34,761,2,1292,Clincha53022b8da673083a6f08004af93a13a519055233cf8d064e45a105eb6055d4d
Cobb,a53022b8da673083a6f08004af93a13a519055233cf8d064e45a105eb6055d4d,97120,11590,83923,334,192967,Cobba53022b8da673083a6f08004af93a13a519055233cf8d064e45a105eb6055d4d
Coffee,a53022b8da673083a6f08004af93a13a519055233cf8d064e45a105eb6055d4d,2912,262,5198,0,8372,Coffeea53022b8da673083a6f08004af93a13a519055233cf8d064e45a105eb6055d4d
Colquitt,a53022b8da673083a6f08004af93a13a519055233cf8d064e45a105eb6055d4d,5004,256,4368,0,9628,Colquitta53022b8da673083a6f08004af93a13a519055233cf8d064e45a105eb6055d4d
Columbia,a53022b8da673083a6f08004af93a13a519055233cf8d064e45a105eb6055d4d,12833,1244,16932,10,31019,Columbiaa53022b8da673083a6f08004af93a13a519055233cf8d064e45a105eb6055d4d
Cook,a53022b8da673083a6f08004af93a13a519055233cf8d064e45a105eb6055d4d,1602,107,1935,0,3644,Cooka53022b8da673083a6f08004af93a13a519055233cf8d064e45a105eb6055d4d
Coweta,a53022b8da673083a6f08004af93a13a519055233cf8d064e45a105eb6055d4d,16189,1415,18079,9,35692,Cowetaa53022b8da673083a6f08004af93a13a519055233cf8d064e45a105eb6055d4d
Crawford,a53022b8da673083a6f08004af93a13a519055233cf8d064e45a105eb6055d4d,1361,144,1569,2,3076,Crawforda53022b8da673083a6f08004af93a13a519055233cf8d064e45a105eb6055d4d
Crisp,a53022b8da673083a6f08004af93a13a519055233cf8d064e45a105eb6055d4d,1321,169,2617,5,4112,Crispa53022b8da673083a6f08004af93a13a519055233cf8d064e45a105eb6055d4d
Dade,a53022b8da673083a6f08004af93a13a519055233cf8d064e45a105eb6055d4d,1761,69,1518,0,3348,Dadea53022b8da673083a6f08004af93a13a519055233cf8d064e45a105eb6055d4d
Dawson,a53022b8da673083a6f08004af93a13a519055233cf8d064e45a105eb6055d4d,1726,262,5034,9,7031,Dawsona53022b8da673083a6f08004af93a13a519055233cf8d064e45a105eb6055d4d
Decatur,a53022b8da673083a6f08004af93a13a519055233cf8d064e45a105eb6055d4d,2289,259,3218,10,5776,Decatura53022b8da673083a6f08004af93a13a519055233cf8d064e45a105eb6055d4d
DeKalb,a53022b8da673083a6f08004af93a13a519055233cf8d064e45a105eb6055d4d,72855,7980,118262,235,199332,DeKalba53022b8da673083a6f08004af93a13a519055233cf8d064e45a105eb6055d4d
Dodge,a53022b8da673083a6f08004af93a13a519055233cf8d064e45a105eb6055d4d,2500,206,1878,1,4585,Dodgea53022b8da673083a6f08004af93a13a519055233cf8d064e45a105eb6055d4d
Dooly,a53022b8da673083a6f08004af93a13a519055233cf8d064e45a105eb6055d4d,863,66,811,8,1748,Doolya53022b8da673083a6f08004af93a13a519055233cf8d064e45a105eb6055d4d
Dougherty,a53022b8da673083a6f08004af93a13a519055233cf8d064e45a105eb6055d4d,11860,801,9035,42,21738,Doughertya53022b8da673083a6f08004af93a13a519055233cf8d064e45a105eb6055d4d
Douglas,a53022b8da673083a6f08004af93a13a519055233cf8d064e45a105eb6055d4d,11349,1240,22207,16,34812,Douglasa53022b8da673083a6f08004af93a13a519055233cf8d064e45a105eb6055d4d
Early,a53022b8da673083a6f08004af93a13a519055233cf8d064e45a105eb6055d4d,1326,212,1349,0,2887,Earlya53022b8da673083a6f08004af93a13a519055233cf8d064e45a105eb6055d4d
Echols,a53022b8da673083a6f08004af93a13a519055233cf8d064e45a105eb6055d4d,266,21,405,0,692,Echolsa53022b8da673083a6f08004af93a13a519055233cf8d064e45a105eb6055d4d
Effingham,a53022b8da673083a6f08004af93a13a519055233cf8d064e45a105eb6055d4d,6213,328,6960,4,13505,Effinghama53022b8da673083a6f08004af93a13a519055233cf8d064e45a105eb6055d4d
Elbert,a53022b8da673083a6f08004af93a13a519055233cf8d064e45a105eb6055d4d,1725,253,2824,24,4826,Elberta53022b8da673083a6f08004af93a13a519055233cf8d064e45a105eb6055d4d
Emanuel,a53022b8da673083a6f08004af93a13a519055233cf8d064e45a105eb6055d4d,2550,205,2060,5,4820,Emanuela53022b8da673083a6f08004af93a13a519055233cf8d064e45a105eb6055d4d
Evans,a53022b8da673083a6f08004af93a13a519055233cf8d064e45a105eb6055d4d,653,111,1388,0,2152,Evansa53022b8da673083a6f08004af93a13a519055233cf8d064e45a105eb6055d4d
Fannin,a53022b8da673083a6f08004af93a13a519055233cf8d064e45a105eb6055d4d,3496,500,3737,6,7739,Fannina53022b8da673083a6f08004af93a13a519055233cf8d064e45a105eb6055d4d
Fayette,a53022b8da673083a6f08004af93a13a519055233cf8d064e45a105eb6055d4d,10694,1363,22601,10,34668,Fayettea53022b8da673083a6f08004af93a13a519055233cf8d064e45a105eb6055d4d
Floyd,a53022b8da673083a6f08004af93a13a519055233cf8d064e45a105eb6055d4d,9792,777,13165,55,23789,Floyda53022b8da673083a6f08004af93a13a519055233cf8d064e45a105eb6055d4d
Forsyth,a53022b8da673083a6f08004af93a13a519055233cf8d064e45a105eb6055d4d,12660,1684,35874,13,50231,Forsytha53022b8da673083a6f08004af93a13a519055233cf8d064e45a105eb6055d4d
Franklin,a53022b8da673083a6f08004af93a13a519055233cf8d064e45a105eb6055d4d,2439,203,2442,0,5084,Franklina53022b8da673083a6f08004af93a13a519055233cf8d064e45a105eb6055d4d
Fulton,a53022b8da673083a6f08004af93a13a519055233cf8d064e45a105eb6055d4d,85787,9378,145550,479,241194,Fultona53022b8da673083a6f08004af93a13a519055233cf8d064e45a105eb6055d4d
Gilmer,a53022b8da673083a6f08004af93a13a519055233cf8d064e45a105eb6055d4d,3447,351,4146,6,7950,Gilmera53022b8da673083a6f08004af93a13a519055233cf8d064e45a105eb6055d4d
Glascock,a53022b8da673083a6f08004af93a13a519055233cf8d064e45a105eb6055d4d,367,45,402,0,814,Glascocka53022b8da673083a6f08004af93a13a519055233cf8d064e45a105eb6055d4d
Glynn,a53022b8da673083a6f08004af93a13a519055233cf8d064e45a105eb6055d4d,7598,718,9605,25,17946,Glynna53022b8da673083a6f08004af93a13a519055233cf8d064e45a105eb6055d4d
Gordon,a53022b8da673083a6f08004af93a13a519055233cf8d064e45a105eb6055d4d,5879,337,5800,7,12023,Gordona53022b8da673083a6f08004af93a13a519055233cf8d064e45a105eb6055d4d
Grady,a53022b8da673083a6f08004af93a13a519055233cf8d064e45a105eb6055d4d,2278,145,2825,5,5253,Gradya53022b8da673083a6f08004af93a13a519055233cf8d064e45a105eb6055d4d
Greene,a53022b8da673083a6f08004af93a13a519055233cf8d064e45a105eb6055d4d,1399,357,2596,5,4357,Greenea53022b8da673083a6f08004af93a13a519055233cf8d064e45a105eb6055d4d
Gwinnett,a53022b8da673083a6f08004af93a13a519055233cf8d064e45a105eb6055d4d,82997,8900,84119,555,176571,Gwinnetta53022b8da673083a6f08004af93a13a519055233cf8d064e45a105eb6055d4d
Habersham,a53022b8da673083a6f08004af93a13a519055233cf8d064e45a105eb6055d4d,1812,532,7500,1,9845,Habershama53022b8da673083a6f08004af93a13a519055233cf8d064e45a105eb6055d4d
Hall,a53022b8da673083a6f08004af93a13a519055233cf8d064e45a105eb6055d4d,18566,1788,19459,28,39841,Halla53022b8da673083a6f08004af93a13a519055233cf8d064e45a105eb6055d4d
Hancock,a53022b8da673083a6f08004af93a13a519055233cf8d064e45a105eb6055d4d,977,234,841,3,2055,Hancocka53022b8da673083a6f08004af93a13a519055233cf8d064e45a105eb6055d4d
Haralson,a53022b8da673083a6f08004af93a13a519055233cf8d064e45a105eb6055d4d,3980,234,3736,6,7956,Haralsona53022b8da673083a6f08004af93a13a519055233cf8d064e45a105eb6055d4d
Harris,a53022b8da673083a6f08004af93a13a519055233cf8d064e45a105eb6055d4d,3641,327,4366,1,8335,Harrisa53022b8da673083a6f08004af93a13a519055233cf8d064e45a105eb6055d4d
Hart,a53022b8da673083a6f08004af93a13a519055233cf8d064e45a105eb6055d4d,2439,214,3107,0,5760,Harta53022b8da673083a6f08004af93a13a519055233cf8d064e45a105eb6055d4d
Heard,a53022b8da673083a6f08004af93a13a519055233cf8d064e45a105eb6055d4d,1479,149,1040,1,2669,Hearda53022b8da673083a6f08004af93a13a519055233cf8d064e45a105eb6055d4d
Henry,a53022b8da673083a6f08004af93a13a519055233cf8d064e45a105eb6055d4d,14906,1760,42219,93,58978,Henrya53022b8da673083a6f08004af93a13a519055233cf8d064e45a105eb6055d4d
Houston,a53022b8da673083a6f08004af93a13a519055233cf8d064e45a105eb6055d4d,10443,1330,23899,35,35707,Houstona53022b8da673083a6f08004af93a13a519055233cf8d064e45a105eb6055d4d
Irwin,a53022b8da673083a6f08004af93a13a519055233cf8d064e45a105eb6055d4d,1304,67,1267,2,2640,Irwina53022b8da673083a6f08004af93a13a519055233cf8d064e45a105eb6055d4d
Jackson,a53022b8da673083a6f08004af93a13a519055233cf8d064e45a105eb6055d4d,6177,466,10839,16,17498,Jacksona53022b8da673083a6f08004af93a13a519055233cf8d064e45a105eb6055d4d
Jasper,a53022b8da673083a6f08004af93a13a519055233cf8d064e45a105eb6055d4d,1379,233,2126,4,3742,Jaspera53022b8da673083a6f08004af93a13a519055233cf8d064e45a105eb6055d4d
Jeff Davis,a53022b8da673083a6f08004af93a13a519055233cf8d064e45a105eb6055d4d,1497,128,1666,0,3291,Jeff Davisa53022b8da673083a6f08004af93a13a519055233cf8d064e45a105eb6055d4d
Jefferson,a53022b8da673083a6f08004af93a13a519055233cf8d064e45a105eb6055d4d,2201,267,1825,4,4297,Jeffersona53022b8da673083a6f08004af93a13a519055233cf8d064e45a105eb6055d4d
Jenkins,a53022b8da673083a6f08004af93a13a519055233cf8d064e45a105eb6055d4d,725,77,894,9,1705,Jenkinsa53022b8da673083a6f08004af93a13a519055233cf8d064e45a105eb6055d4d
Johnson,a53022b8da673083a6f08004af93a13a519055233cf8d064e45a105eb6055d4d,988,125,1353,0,2466,Johnsona53022b8da673083a6f08004af93a13a519055233cf8d064e45a105eb6055d4d
Jones,a53022b8da673083a6f08004af93a13a519055233cf8d064e45a105eb6055d4d,3014,404,4955,1,8374,Jonesa53022b8da673083a6f08004af93a13a519055233cf8d064e45a105eb6055d4d
Lamar,a53022b8da673083a6f08004af93a13a519055233cf8d064e45a105eb6055d4d,1963,219,2818,6,5006,Lamara53022b8da673083a6f08004af93a13a519055233cf8d064e45a105eb6055d4d
Lanier,a53022b8da673083a6f08004af93a13a519055233cf8d064e45a105eb6055d4d,607,28,832,0,1467,Laniera53022b8da673083a6f08004af93a13a519055233cf8d064e45a105eb6055d4d
Laurens,a53022b8da673083a6f08004af93a13a519055233cf8d064e45a105eb6055d4d,6985,698,5865,0,13548,Laurensa53022b8da673083a6f08004af93a13a519055233cf8d064e45a105eb6055d4d
Lee,a53022b8da673083a6f08004af93a13a519055233cf8d064e45a105eb6055d4d,4132,228,4158,2,8520,Leea53022b8da673083a6f08004af93a13a519055233cf8d064e45a105eb6055d4d
Liberty,a53022b8da673083a6f08004af93a13a519055233cf8d064e45a105eb6055d4d,3158,256,4662,11,8087,Libertya53022b8da673083a6f08004af93a13a519055233cf8d064e45a105eb6055d4d
Lincoln,a53022b8da673083a6f08004af93a13a519055233cf8d064e45a105eb6055d4d,927,230,1267,0,2424,Lincolna53022b8da673083a6f08004af93a13a519055233cf8d064e45a105eb6055d4d
Long,a53022b8da673083a6f08004af93a13a519055233cf8d064e45a105eb6055d4d,1159,52,1143,2,2356,Longa53022b8da673083a6f08004af93a13a519055233cf8d064e45a105eb6055d4d
Lowndes,a53022b8da673083a6f08004af93a13a519055233cf8d064e45a105eb6055d4d,5996,658,13106,196,19956,Lowndesa53022b8da673083a6f08004af93a13a519055233cf8d064e45a105eb6055d4d
Lumpkin,a53022b8da673083a6f08004af93a13a519055233cf8d064e45a105eb6055d4d,1712,340,5920,6,7978,Lumpkina53022b8da673083a6f08004af93a13a519055233cf8d064e45a105eb6055d4d
Macon,a53022b8da673083a6f08004af93a13a519055233cf8d064e45a105eb6055d4d,971,109,1183,0,2263,Macona53022b8da673083a6f08004af93a13a519055233cf8d064e45a105eb6055d4d
Madison,a53022b8da673083a6f08004af93a13a519055233cf8d064e45a105eb6055d4d,3884,323,4590,3,8800,Madisona53022b8da673083a6f08004af93a13a519055233cf8d064e45a105eb6055d4d
Marion,a53022b8da673083a6f08004af93a13a519055233cf8d064e45a105eb6055d4d,910,127,693,0,1730,Mariona53022b8da673083a6f08004af93a13a519055233cf8d064e45a105eb6055d4d
McDuffie,a53022b8da673083a6f08004af93a13a519055233cf8d064e45a105eb6055d4d,1817,270,3179,0,5266,McDuffiea53022b8da673083a6f08004af93a13a519055233cf8d064e45a105eb6055d4d
McIntosh,a53022b8da673083a6f08004af93a13a519055233cf8d064e45a105eb6055d4d,1225,318,1587,4,3134,McIntosha53022b8da673083a6f08004af93a13a519055233cf8d064e45a105eb6055d4d
Meriwether,a53022b8da673083a6f08004af93a13a519055233cf8d064e45a105eb6055d4d,3292,215,2102,4,5613,Meriwethera53022b8da673083a6f08004af93a13a519055233cf8d064e45a105eb6055d4d
Miller,a53022b8da673083a6f08004af93a13a519055233cf8d064e45a105eb6055d4d,669,85,733,3,1490,Millera53022b8da673083a6f08004af93a13a519055233cf8d064e45a105eb6055d4d
Mitchell,a53022b8da673083a6f08004af93a13a519055233cf8d064e45a105eb6055d4d,2468,354,2342,4,5168,Mitchella53022b8da673083a6f08004af93a13a519055233cf8d064e45a105eb6055d4d
Monroe,a53022b8da673083a6f08004af93a13a519055233cf8d064e45a105eb6055d4d,3511,307,3869,6,7693,Monroea53022b8da673083a6f08004af93a13a519055233cf8d064e45a105eb6055d4d
Montgomery,a53022b8da673083a6f08004af93a13a519055233cf8d064e45a105eb6055d4d,1486,69,854,0,2409,Montgomerya53022b8da673083a6f08004af93a13a519055233cf8d064e45a105eb6055d4d
Morgan,a53022b8da673083a6f08004af93a13a519055233cf8d064e45a105eb6055d4d,2281,220,3578,3,6082,Morgana53022b8da673083a6f08004af93a13a519055233cf8d064e45a105eb6055d4d
Murray,a53022b8da673083a6f08004af93a13a519055233cf8d064e45a105eb6055d4d,3908,177,3409,0,7494,Murraya53022b8da673083a6f08004af93a13a519055233cf8d064e45a105eb6055d4d
Muscogee,a53022b8da673083a6f08004af93a13a519055233cf8d064e45a105eb6055d4d,14284,1605,16526,43,32458,Muscogeea53022b8da673083a6f08004af93a13a519055233cf8d064e45a105eb6055d4d
Newton,a53022b8da673083a6f08004af93a13a519055233cf8d064e45a105eb6055d4d,12304,1086,13665,2,27057,Newtona53022b8da673083a6f08004af93a13a519055233cf8d064e45a105eb6055d4d
Oconee,a53022b8da673083a6f08004af93a13a519055233cf8d064e45a105eb6055d4d,5348,504,8208,6,14066,Oconeea53022b8da673083a6f08004af93a13a519055233cf8d064e45a105eb6055d4d
Oglethorpe,a53022b8da673083a6f08004af93a13a519055233cf8d064e45a105eb6055d4d,1751,225,2958,0,4934,Oglethorpea53022b8da673083a6f08004af93a13a519055233cf8d064e45a105eb6055d4d
Paulding,a53022b8da673083a6f08004af93a13a519055233cf8d064e45a105eb6055d4d,11371,1609,26466,9,39455,Pauldinga53022b8da673083a6f08004af93a13a519055233cf8d064e45a105eb6055d4d
Peach,a53022b8da673083a6f08004af93a13a519055233cf8d064e45a105eb6055d4d,1728,190,4061,9,5988,Peacha53022b8da673083a6f08004af93a13a519055233cf8d064e45a105eb6055d4d
Pickens,a53022b8da673083a6f08004af93a13a519055233cf8d064e45a105eb6055d4d,3333,148,5220,2,8703,Pickensa53022b8da673083a6f08004af93a13a519055233cf8d064e45a105eb6055d4d
Pierce,a53022b8da673083a6f08004af93a13a519055233cf8d064e45a105eb6055d4d,1320,208,3354,1,4883,Piercea53022b8da673083a6f08004af93a13a519055233cf8d064e45a105eb6055d4d
Pike,a53022b8da673083a6f08004af93a13a519055233cf8d064e45a105eb6055d4d,2080,215,3321,2,5618,Pikea53022b8da673083a6f08004af93a13a519055233cf8d064e45a105eb6055d4d
Polk,a53022b8da673083a6f08004af93a13a519055233cf8d064e45a105eb6055d4d,2912,290,6263,3,9468,Polka53022b8da673083a6f08004af93a13a519055233cf8d064e45a105eb6055d4d
Pulaski,a53022b8da673083a6f08004af93a13a519055233cf8d064e45a105eb6055d4d,475,122,1524,0,2121,Pulaskia53022b8da673083a6f08004af93a13a519055233cf8d064e45a105eb6055d4d
Putnam,a53022b8da673083a6f08004af93a13a519055233cf8d064e45a105eb6055d4d,2090,325,3303,1,5719,Putnama53022b8da673083a6f08004af93a13a519055233cf8d064e45a105eb6055d4d
Quitman,a53022b8da673083a6f08004af93a13a519055233cf8d064e45a105eb6055d4d,235,13,218,0,466,Quitmana53022b8da673083a6f08004af93a13a519055233cf8d064e45a105eb6055d4d
Rabun,a53022b8da673083a6f08004af93a13a519055233cf8d064e45a105eb6055d4d,785,445,3462,0,4692,Rabuna53022b8da673083a6f08004af93a13a519055233cf8d064e45a105eb6055d4d
Randolph,a53022b8da673083a6f08004af93a13a519055233cf8d064e45a105eb6055d4d,699,59,527,1,1286,Randolpha53022b8da673083a6f08004af93a13a519055233cf8d064e45a105eb6055d4d
Richmond,a53022b8da673083a6f08004af93a13a519055233cf8d064e45a105eb6055d4d,18120,2105,20448,43,40716,Richmonda53022b8da673083a6f08004af93a13a519055233cf8d064e45a105eb6055d4d
Rockdale,a53022b8da673083a6f08004af93a13a519055233cf8d064e45a105eb6055d4d,5958,670,16373,14,23015,Rockdalea53022b8da673083a6f08004af93a13a519055233cf8d064e45a105eb6055d4d
Schley,a53022b8da673083a6f08004af93a13a519055233cf8d064e45a105eb6055d4d,362,54,810,0,1226,Schleya53022b8da673083a6f08004af93a13a519055233cf8d064e45a105eb6055d4d
Screven,a53022b8da673083a6f08004af93a13a519055233cf8d064e45a105eb6055d4d,1607,90,1714,0,3411,Screvena53022b8da673083a6f08004af93a13a519055233cf8d064e45a105eb6055d4d
Seminole,a53022b8da673083a6f08004af93a13a519055233cf8d064e45a105eb6055d4d,1157,93,736,1,1987,Seminolea53022b8da673083a6f08004af93a13a519055233cf8d064e45a105eb6055d4d
Spalding,a53022b8da673083a6f08004af93a13a519055233cf8d064e45a105eb6055d4d,5522,583,9101,9,15215,Spaldinga53022b8da673083a6f08004af93a13a519055233cf8d064e45a105eb6055d4d
Stephens,a53022b8da673083a6f08004af93a13a519055233cf8d064e45a105eb6055d4d,1057,336,4484,1,5878,Stephensa53022b8da673083a6f08004af93a13a519055233cf8d064e45a105eb6055d4d
Stewart,a53022b8da673083a6f08004af93a13a519055233cf8d064e45a105eb6055d4d,492,116,303,2,913,Stewarta53022b8da673083a6f08004af93a13a519055233cf8d064e45a105eb6055d4d
Sumter,a53022b8da673083a6f08004af93a13a519055233cf8d064e45a105eb6055d4d,2922,437,3400,1,6760,Sumtera53022b8da673083a6f08004af93a13a519055233cf8d064e45a105eb6055d4d
Talbot,a53022b8da673083a6f08004af93a13a519055233cf8d064e45a105eb6055d4d,956,186,417,0,1559,Talbota53022b8da673083a6f08004af93a13a519055233cf8d064e45a105eb6055d4d
Taliaferro,a53022b8da673083a6f08004af93a13a519055233cf8d064e45a105eb6055d4d,176,43,228,1,448,Taliaferroa53022b8da673083a6f08004af93a13a519055233cf8d064e45a105eb6055d4d
Tattnall,a53022b8da673083a6f08004af93a13a519055233cf8d064e45a105eb6055d4d,1692,349,2379,2,4422,Tattnalla53022b8da673083a6f08004af93a13a519055233cf8d064e45a105eb6055d4d
Taylor,a53022b8da673083a6f08004af93a13a519055233cf8d064e45a105eb6055d4d,792,150,1177,0,2119,Taylora53022b8da673083a6f08004af93a13a519055233cf8d064e45a105eb6055d4d
Telfair,a53022b8da673083a6f08004af93a13a519055233cf8d064e45a105eb6055d4d,1262,270,1032,1,2565,Telfaira53022b8da673083a6f08004af93a13a519055233cf8d064e45a105eb6055d4d
Terrell,a53022b8da673083a6f08004af93a13a519055233cf8d064e45a105eb6055d4d,1201,128,1146,0,2475,Terrella53022b8da673083a6f08004af93a13a519055233cf8d064e45a105eb6055d4d
Thomas,a53022b8da673083a6f08004af93a13a519055233cf8d064e45a105eb6055d4d,3869,383,5736,1,9989,Thomasa53022b8da673083a6f08004af93a13a519055233cf8d064e45a105eb6055d4d
Tift,a53022b8da673083a6f08004af93a13a519055233cf8d064e45a105eb6055d4d,3495,248,4830,4,8577,Tifta53022b8da673083a6f08004af93a13a519055233cf8d064e45a105eb6055d4d
Toombs,a53022b8da673083a6f08004af93a13a519055233cf8d064e45a105eb6055d4d,2357,357,3152,2,5868,Toombsa53022b8da673083a6f08004af93a13a519055233cf8d064e45a105eb6055d4d
Towns,a53022b8da673083a6f08004af93a13a519055233cf8d064e45a105eb6055d4d,1048,204,2484,5,3741,Townsa53022b8da673083a6f08004af93a13a519055233cf8d064e45a105eb6055d4d
Treutlen,a53022b8da673083a6f08004af93a13a519055233cf8d064e45a105eb6055d4d,575,96,962,2,1635,Treutlena53022b8da673083a6f08004af93a13a519055233cf8d064e45a105eb6055d4d
Troup,a53022b8da673083a6f08004af93a13a519055233cf8d064e45a105eb6055d4d,6914,627,7895,86,15522,Troupa53022b8da673083a6f08004af93a13a519055233cf8d064e45a105eb6055d4d
Turner,a53022b8da673083a6f08004af93a13a519055233cf8d064e45a105eb6055d4d,710,47,1289,0,2046,Turnera53022b8da673083a6f08004af93a13a519055233cf8d064e45a105eb6055d4d
Twiggs,a53022b8da673083a6f08004af93a13a519055233cf8d064e45a105eb6055d4d,1265,190,972,0,2427,Twiggsa53022b8da673083a6f08004af93a13a519055233cf8d064e45a105eb6055d4d
Union,a53022b8da673083a6f08004af93a13a519055233cf8d064e45a105eb6055d4d,2609,331,4525,3,7468,Uniona53022b8da673083a6f08004af93a13a519055233cf8d064e45a105eb6055d4d
Upson,a53022b8da673083a6f08004af93a13a519055233cf8d064e45a105eb6055d4d,1784,260,4597,7,6648,Upsona53022b8da673083a6f08004af93a13a519055233cf8d064e45a105eb6055d4d
Walker,a53022b8da673083a6f08004af93a13a519055233cf8d064e45a105eb6055d4d,5411,485,8514,6,14416,Walkera53022b8da673083a6f08004af93a13a519055233cf8d064e45a105eb6055d4d
Walton,a53022b8da673083a6f08004af93a13a519055233cf8d064e45a105eb6055d4d,12367,906,10467,19,23759,Waltona53022b8da673083a6f08004af93a13a519055233cf8d064e45a105eb6055d4d
Ware,a53022b8da673083a6f08004af93a13a519055233cf8d064e45a105eb6055d4d,3040,313,4179,6,7538,Warea53022b8da673083a6f08004af93a13a519055233cf8d064e45a105eb6055d4d
Warren,a53022b8da673083a6f08004af93a13a519055233cf8d064e45a105eb6055d4d,558,62,695,1,1316,Warrena53022b8da673083a6f08004af93a13a519055233cf8d064e45a105eb6055d4d
Washington,a53022b8da673083a6f08004af93a13a519055233cf8d064e45a105eb6055d4d,2486,421,2770,15,5692,Washingtona53022b8da673083a6f08004af93a13a519055233cf8d064e45a105eb6055d4d
Wayne,a53022b8da673083a6f08004af93a13a519055233cf8d064e45a105eb6055d4d,2655,241,3612,2,6510,Waynea53022b8da673083a6f08004af93a13a519055233cf8d064e45a105eb6055d4d
Webster,a53022b8da673083a6f08004af93a13a519055233cf8d064e45a105eb6055d4d,281,63,297,1,642,Webstera53022b8da673083a6f08004af93a13a519055233cf8d064e45a105eb6055d4d
Wheeler,a53022b8da673083a6f08004af93a13a519055233cf8d064e45a105eb6055d4d,635,87,599,2,1323,Wheelera53022b8da673083a6f08004af93a13a519055233cf8d064e45a105eb6055d4d
White,a53022b8da673083a6f08004af93a13a519055233cf8d064e45a105eb6055d4d,3131,324,3993,6,7454,Whitea53022b8da673083a6f08004af93a13a519055233cf8d064e45a105eb6055d4d
Whitfield,a53022b8da673083a6f08004af93a13a519055233cf8d064e45a105eb6055d4d,9556,595,7892,21,18064,Whitfielda53022b8da673083a6f08004af93a13a519055233cf8d064e45a105eb6055d4d
Wilcox,a53022b8da673083a6f08004af93a13a519055233cf8d064e45a105eb6055d4d,1053,119,811,0,1983,Wilcoxa53022b8da673083a6f08004af93a13a519055233cf8d064e45a105eb6055d4d
Wilkes,a53022b8da673083a6f08004af93a13a519055233cf8d064e45a105eb6055d4d,1412,100,1339,1,2852,Wilkesa53022b8da673083a6f08004af93a13a519055233cf8d064e45a105eb6055d4d
Wilkinson,a53022b8da673083a6f08004af93a13a519055233cf8d064e45a105eb6055d4d,1659,115,1003,3,2780,Wilkinsona53022b8da673083a6f08004af93a13a519055233cf8d064e45a105eb6055d4d
Worth,a53022b8da673083a6f08004af93a13a519055233cf8d064e45a105eb6055d4d,3098,158,2204,5,5465,Wortha53022b8da673083a6f08004af93a13a519055233cf8d064e45a105eb6055d4d
Appling,19d7cedea74d09551f8e0099b3d0f6da41a20bc127b08d37166169066ccab077,2769,435,2135,2,5341,Appling19d7cedea74d09551f8e0099b3d0f6da41a20bc127b08d37166169066ccab077
Atkinson,19d7cedea74d09551f8e0099b3d0f6da41a20bc127b08d37166169066ccab077,885,71,912,1,1869,Atkinson19d7cedea74d09551f8e0099b3d0f6da41a20bc127b08d37166169066ccab077
Bacon,19d7cedea74d09551f8e0099b3d0f6da41a20bc127b08d37166169066ccab077,1069,138,1878,5,3090,Bacon19d7cedea74d09551f8e0099b3d0f6da41a20bc127b08d37166169066ccab077
Baker,19d7cedea74d09551f8e0099b3d0f6da41a20bc127b08d37166169066ccab077,489,109,392,1,991,Baker19d7cedea74d09551f8e0099b3d0f6da41a20bc127b08d37166169066ccab077
Baldwin,19d7cedea74d09551f8e0099b3d0f6da41a20bc127b08d37166169066ccab077,4855,908,6910,6,12679,Baldwin19d7cedea74d09551f8e0099b3d0f6da41a20bc127b08d37166169066ccab077
Banks,19d7cedea74d09551f8e0099b3d0f6da41a20bc127b08d37166169066ccab077,2811,202,2588,1,5602,Banks19d7cedea74d09551f8e0099b3d0f6da41a20bc127b08d37166169066ccab077
Barrow,19d7cedea74d09551f8e0099b3d0f6da41a20bc127b08d37166169066ccab077,10162,1002,12514,1,23679,Barrow19d7cedea74d09551f8e0099b3d0f6da41a20bc127b08d37166169066ccab077
Bartow,19d7cedea74d09551f8e0099b3d0f6da41a20bc127b08d37166169066ccab077,16448,1262,14361,24,32095,Bartow19d7cedea74d09551f8e0099b3d0f6da41a20bc127b08d37166169066ccab077
Ben Hill,19d7cedea74d09551f8e0099b3d0f6da41a20bc127b08d37166169066ccab077,1221,188,3043,6,4458,Ben Hill19d7cedea74d09551f8e0099b3d0f6da41a20bc127b08d37166169066ccab077
Berrien,19d7cedea74d09551f8e0099b3d0f6da41a20bc127b08d37166169066ccab077,2350,315,2670,14,5349,Berrien19d7cedea74d09551f8e0099b3d0f6da41a20bc127b08d37166169066ccab077
Bibb,19d7cedea74d09551f8e0099b3d0f6da41a20bc127b08d37166169066ccab077,23441,3056,22775,162,49434,Bibb19d7cedea74d09551f8e0099b3d0f6da41a20bc127b08d37166169066ccab077
Bleckley,19d7cedea74d09551f8e0099b3d0f6da41a20bc127b08d37166169066ccab077,1621,208,2135,4,3968,Bleckley19d7cedea74d09551f8e0099b3d0f6da41a20bc127b08d37166169066ccab077
Brantley,19d7cedea74d09551f8e0099b3d0f6da41a20bc127b08d37166169066ccab077,2163,181,2470,6,4820,Brantley19d7cedea74d09551f8e0099b3d0f6da41a20bc127b08d37166169066ccab077
Brooks,19d7cedea74d09551f8e0099b3d0f6da41a20bc127b08d37166169066ccab077,2166,461,2171,38,4836,Brooks19d7cedea74d09551f8e0099b3d0f6da41a20bc127b08d37166169066ccab077
Bryan,19d7cedea74d09551f8e0099b3d0f6da41a20bc127b08d37166169066ccab077,4778,466,7646,9,12899,Bryan19d7cedea74d09551f8e0099b3d0f6da41a20bc127b08d37166169066ccab077
Bulloch,19d7cedea74d09551f8e0099b3d0f6da41a20bc127b08d37166169066ccab077,9395,858,9890,42,20185,Bulloch19d7cedea74d09551f8e0099b3d0f6da41a20bc127b08d37166169066ccab077
Burke,19d7cedea74d09551f8e0099b3d0f6da41a20bc127b08d37166169066ccab077,3696,748,2900,0,7344,Burke19d7cedea74d09551f8e0099b3d0f6da41a20bc127b08d37166169066ccab077
Butts,19d7cedea74d09551f8e0099b3d0f6da41a20bc127b08d37166169066ccab077,2166,239,5254,0,7659,Butts19d7cedea74d09551f8e0099b3d0f6da41a20bc127b08d37166169066ccab077
Calhoun,19d7cedea74d09551f8e0099b3d0f6da41a20bc127b08d37166169066ccab077,814,112,494,1,1421,Calhoun19d7cedea74d09551f8e0099b3d0f6da41a20bc127b08d37166169066ccab077
Camden,19d7cedea74d09551f8e0099b3d0f6da41a20bc127b08d37166169066ccab077,5905,927,8521,16,15369,Camden19d7cedea74d09551f8e0099b3d0f6da41a20bc127b08d37166169066ccab077
Candler,19d7cedea74d09551f8e0099b3d0f6da41a20bc127b08d37166169066ccab077,794,115,2067,5,2981,Candler19d7cedea74d09551f8e0099b3d0f6da41a20bc127b08d37166169066ccab077
Carroll,19d7cedea74d09551f8e0099b3d0f6da41a20bc127b08d37166169066ccab077,15240,1231,19171,70,35712,Carroll19d7cedea74d09551f8e0099b3d0f6da41a20bc127b08d37166169066ccab077
Catoosa,19d7cedea74d09551f8e0099b3d0f6da41a20bc127b08d37166169066ccab077,7489,570,14095,13,22167,Catoosa19d7cedea74d09551f8e0099b3d0f6da41a20bc127b08d37166169066ccab077
Charlton,19d7cedea74d09551f8e0099b3d0f6da41a20bc127b08d37166169066ccab077,1225,170,1587,5,2987,Charlton19d7cedea74d09551f8e0099b3d0f6da41a20bc127b08d37166169066ccab077
Chatham,19d7cedea74d09551f8e0099b3d0f6da41a20bc127b08d37166169066ccab077,57265,4236,28659,94,90254,Chatham19d7cedea74d09551f8e0099b3d0f6da41a20bc127b08d37166169066ccab077
Chattahoochee,19d7cedea74d09551f8e0099b3d0f6da41a20bc127b08d37166169066ccab077,571,38,459,6,1074,Chattahoochee19d7cedea74d09551f8e0099b3d0f6da41a20bc127b08d37166169066ccab077
Chattooga,19d7cedea74d09551f8e0099b3d0f6da41a20bc127b08d37166169066ccab077,2987,195,3325,4,6511,Chattooga19d7cedea74d09551f8e0099b3d0f6da41a20bc127b08d37166169066ccab077
Cherokee,19d7cedea74d09551f8e0099b3d0f6da41a20bc127b08d37166169066ccab077,36706,4491,50539,22,91758,Cherokee19d7cedea74d09551f8e0099b3d0f6da41a20bc127b08d37166169066ccab077
Clarke,19d7cedea74d09551f8e0099b3d0f6da41a20bc127b08d37166169066ccab077,13701,2062,16124,64,31951,Clarke19d7cedea74d09551f8e0099b3d0f6da41a20bc127b08d37166169066ccab077
Clay,19d7cedea74d09551f8e0099b3d0f6da41a20bc127b08d37166169066ccab077,374,74,484,3,935,Clay19d7cedea74d09551f8e0099b3d0f6da41a20bc127b08d37166169066ccab077
Clayton,19d7cedea74d09551f8e0099b3d0f6da41a20bc127b08d37166169066ccab077,27433,2585,46845,121,76984,Clayton19d7cedea74d09551f8e0099b3d0f6da41a20bc127b08d37166169066ccab077
Clinch,19d7cedea74d09551f8e0099b3d0f6da41a20bc127b08d37166169066ccab077,749,62,990,3,1804,Clinch19d7cedea74d09551f8e0099b3d0f6da41a20bc127b08d37166169066ccab077
Cobb,19d7cedea74d09551f8e0099b3d0f6da41a20bc127b08d37166169066ccab077,133497,19329,114618,592,268036,Cobb19d7cedea74d09551f8e0099b3d0f6da41a20bc127b08d37166169066ccab077
Coffee,19d7cedea74d09551f8e0099b3d0f6da41a20bc127b08d37166169066ccab077,3584,381,6682,0,10647,Coffee19d7cedea74d09551f8e0099b3d0f6da41a20bc127b08d37166169066ccab077
Colquitt,19d7cedea74d09551f8e0099b3d0f6da41a20bc127b08d37166169066ccab077,5493,381,5051,5,10930,Colquitt19d7cedea74d09551f8e0099b3d0f6da41a20bc127b08d37166169066ccab077
Columbia,19d7cedea74d09551f8e0099b3d0f6da41a20bc127b08d37166169066ccab077,22019,2770,30244,26,55059,Columbia19d7cedea74d09551f8e0099b3d0f6da41a20bc127b08d37166169066ccab077
Cook,19d7cedea74d09551f8e0099b3d0f6da41a20bc127b08d37166169066ccab077,1996,195,2678,0,4869,Cook19d7cedea74d09551f8e0099b3d0f6da41a20bc127b08d37166169066ccab077
Coweta,19d7cedea74d09551f8e0099b3d0f6da41a20bc127b08d37166169066ccab077,22022,2422,25290,17,49751,Coweta19d7cedea74d09551f8e0099b3d0f6da41a20bc127b08d37166169066ccab077
Crawford,19d7cedea74d09551f8e0099b3d0f6da41a20bc127b08d37166169066ccab077,1800,212,2021,3,4036,Crawford19d7cedea74d09551f8e0099b3d0f6da41a20bc127b08d37166169066ccab077
Crisp,19d7cedea74d09551f8e0099b3d0f6da41a20bc127b08d37166169066ccab077,1895,272,3706,9,5882,Crisp19d7cedea74d09551f8e0099b3d0f6da41a20bc127b08d37166169066ccab077
Dade,19d7cedea74d09551f8e0099b3d0f6da41a20bc127b08d37166169066ccab077,2609,142,2352,1,5104,Dade19d7cedea74d09551f8e0099b3d0f6da41a20bc127b08d37166169066ccab077
Dawson,19d7cedea74d09551f8e0099b3d0f6da41a20bc127b08d37166169066ccab077,2407,435,6607,16,9465,Dawson19d7cedea74d09551f8e0099b3d0f6da41a20bc127b08d37166169066ccab077
Decatur,19d7cedea74d09551f8e0099b3d0f6da41a20bc127b08d37166169066ccab077,3032,415,4220,20,7687,Decatur19d7cedea74d09551f8e0099b3d0f6da41a20bc127b08d37166169066ccab077
DeKalb,19d7cedea74d09551f8e0099b3d0f6da41a20bc127b08d37166169066ccab077,93586,12658,144363,352,250959,DeKalb19d7cedea74d09551f8e0099b3d0f6da41a20bc127b08d37166169066ccab077
Dodge,19d7cedea74d09551f8e0099b3d0f6da41a20bc127b08d37166169066ccab077,2745,268,2192,1,5206,Dodge19d7cedea74d09551f8e0099b3d0f6da41a20bc127b08d37166169066ccab077
Dooly,19d7cedea74d09551f8e0099b3d0f6da41a20bc127b08d37166169066ccab077,1310,145,1358,14,2827,Dooly19d7cedea74d09551f8e0099b3d0f6da41a20bc127b08d37166169066ccab077
Dougherty,19d7cedea74d09551f8e0099b3d0f6da41a20bc127b08d37166169066ccab077,14135,1334,11523,64,27056,Dougherty19d7cedea74d09551f8e0099b3d0f6da41a20bc127b08d37166169066ccab077
Douglas,19d7cedea74d09551f8e0099b3d0f6da41a20bc127b08d37166169066ccab077,15743,2024,29534,27,47328,Douglas19d7cedea74d09551f8e0099b3d0f6da41a20bc127b08d37166169066ccab077
Early,19d7cedea74d09551f8e0099b3d0f6da41a20bc127b08d37166169066ccab077,1558,289,1646,0,3493,Early19d7cedea74d09551f8e0099b3d0f6da41a20bc127b08d37166169066ccab077
Echols,19d7cedea74d09551f8e0099b3d0f6da41a20bc127b08d37166169066ccab077,354,30,535,0,919,Echols19d7cedea74d09551f8e0099b3d0f6da41a20bc127b08d37166169066ccab077
Effingham,19d7cedea74d09551f8e0099b3d0f6da41a20bc127b08d37166169066ccab077,9156,578,10072,7,19813,Effingham19d7cedea74d09551f8e0099b3d0f6da41a20bc127b08d37166169066ccab077
Elbert,19d7cedea74d09551f8e0099b3d0f6da41a20bc127b08d37166169066ccab077,2224,392,3542,49,6207,Elbert19d7cedea74d09551f8e0099b3d0f6da41a20bc127b08d37166169066ccab077
Emanuel,19d7cedea74d09551f8e0099b3d0f6da41a20bc127b08d37166169066ccab077,3215,262,2625,7,6109,Emanuel19d7cedea74d09551f8e0099b3d0f6da41a20bc127b08d37166169066ccab077
Evans,19d7cedea74d09551f8e0099b3d0f6da41a20bc127b08d37166169066ccab077,869,136,1756,0,2761,Evans19d7cedea74d09551f8e0099b3d0f6da41a20bc127b08d37166169066ccab077
Fannin,19d7cedea74d09551f8e0099b3d0f6da41a20bc127b08d37166169066ccab077,3871,651,4664,7,9193,Fannin19d7cedea74d09551f8e0099b3d0f6da41a20bc127b08d37166169066ccab077
Fayette,19d7cedea74d09551f8e0099b3d0f6da41a20bc127b08d37166169066ccab077,14588,2391,31692,18,48689,Fayette19d7cedea74d09551f8e0099b3d0f6da41a20bc127b08d37166169066ccab077
Floyd,19d7cedea74d09551f8e0099b3d0f6da41a20bc127b08d37166169066ccab077,11332,1125,15206,81,27744,Floyd19d7cedea74d09551f8e0099b3d0f6da41a20bc127b08d37166169066ccab077
Forsyth,19d7cedea74d09551f8e0099b3d0f6da41a20bc127b08d37166169066ccab077,21376,3408,57604,34,82422,Forsyth19d7cedea74d09551f8e0099b3d0f6da41a20bc127b08d37166169066ccab077
Franklin,19d7cedea74d09551f8e0099b3d0f6da41a20bc127b08d37166169066ccab077,3306,338,3183,0,6827,Franklin19d7cedea74d09551f8e0099b3d0f6da41a20bc127b08d37166169066ccab077
Fulton,19d7cedea74d09551f8e0099b3d0f6da41a20bc127b08d37166169066ccab077,121666,17160,212011,876,351713,Fulton19d7cedea74d09551f8e0099b3d0f6da41a20bc127b08d37166169066ccab077
Gilmer,19d7cedea74d09551f8e0099b3d0f6da41a20bc127b08d37166169066ccab077,3979,556,5330,9,9874,Gilmer19d7cedea74d09551f8e0099b3d0f6da41a20bc127b08d37166169066ccab077
Glascock,19d7cedea74d09551f8e0099b3d0f6da41a20bc127b08d37166169066ccab077,478,59,544,0,1081,Glascock19d7cedea74d09551f8e0099b3d0f6da41a20bc127b08d37166169066ccab077
Glynn,19d7cedea74d09551f8e0099b3d0f6da41a20bc127b08d37166169066ccab077,11259,1278,14784,44,27365,Glynn19d7cedea74d09551f8e0099b3d0f6da41a20bc127b08d37166169066ccab077
Gordon,19d7cedea74d09551f8e0099b3d0f6da41a20bc127b08d37166169066ccab077,7024,488,7599,16,15127,Gordon19d7cedea74d09551f8e0099b3d0f6da41a20bc127b08d37166169066ccab077
Grady,19d7cedea74d09551f8e0099b3d0f6da41a20bc127b08d37166169066ccab077,2960,218,3818,7,7003,Grady19d7cedea74d09551f8e0099b3d0f6da41a20bc127b08d37166169066ccab077
Greene,19d7cedea74d09551f8e0099b3d0f6da41a20bc127b08d37166169066ccab077,2035,457,4490,5,6987,Greene19d7cedea74d09551f8e0099b3d0f6da41a20bc127b08d37166169066ccab077
Gwinnett,19d7cedea74d09551f8e0099b3d0f6da41a20bc127b08d37166169066ccab077,130590,15662,125483,1205,272940,Gwinnett19d7cedea74d09551f8e0099b3d0f6da41a20bc127b08d37166169066ccab077
Habersham,19d7cedea74d09551f8e0099b3d0f6da41a20bc127b08d37166169066ccab077,2726,815,9702,3,13246,Habersham19d7cedea74d09551f8e0099b3d0f6da41a20bc127b08d37166169066ccab077
Hall,19d7cedea74d09551f8e0099b3d0f6da41a20bc127b08d37166169066ccab077,26260,2968,28355,51,57634,Hall19d7cedea74d09551f8e0099b3d0f6da41a20bc127b08d37166169066ccab077
Hancock,19d7cedea74d09551f8e0099b3d0f6da41a20bc127b08d37166169066ccab077,1178,269,1007,6,2460,Hancock19d7cedea74d09551f8e0099b3d0f6da41a20bc127b08d37166169066ccab077
Haralson,19d7cedea74d09551f8e0099b3d0f6da41a20bc127b08d37166169066ccab077,4525,374,4318,6,9223,Haralson19d7cedea74d09551f8e0099b3d0f6da41a20bc127b08d37166169066ccab077
Harris,19d7cedea74d09551f8e0099b3d0f6da41a20bc127b08d37166169066ccab077,5701,605,7322,1,13629,Harris19d7cedea74d09551f8e0099b3d0f6da41a20bc127b08d37166169066ccab077
Hart,19d7cedea74d09551f8e0099b3d0f6da41a20bc127b08d37166169066ccab077,3283,369,4091,1,7744,Hart19d7cedea74d09551f8e0099b3d0f6da41a20bc127b08d37166169066ccab077
Heard,19d7cedea74d09551f8e0099b3d0f6da41a20bc127b08d37166169066ccab077,1780,217,1334,2,3333,Heard19d7cedea74d09551f8e0099b3d0f6da41a20bc127b08d37166169066ccab077
Henry,19d7cedea74d09551f8e0099b3d0f6da41a20bc127b08d37166169066ccab077,21691,3018,57135,148,81992,Henry19d7cedea74d09551f8e0099b3d0f6da41a20bc127b08d37166169066ccab077
Houston,19d7cedea74d09551f8e0099b3d0f6da41a20bc127b08d37166169066ccab077,15230,2168,31168,103,48669,Houston19d7cedea74d09551f8e0099b3d0f6da41a20bc127b08d37166169066ccab077
Irwin,19d7cedea74d09551f8e0099b3d0f6da41a20bc127b08d37166169066ccab077,1236,100,1368,5,2709,Irwin19d7cedea74d09551f8e0099b3d0f6da41a20bc127b08d37166169066ccab077
Jackson,19d7cedea74d09551f8e0099b3d0f6da41a20bc127b08d37166169066ccab077,7968,690,13262,42,21962,Jackson19d7cedea74d09551f8e0099b3d0f6da41a20bc127b08d37166169066ccab077
Jasper,19d7cedea74d09551f8e0099b3d0f6da41a20bc127b08d37166169066ccab077,1833,310,2683,5,4831,Jasper19d7cedea74d09551f8e0099b3d0f6da41a20bc127b08d37166169066ccab077
Jeff Davis,19d7cedea74d09551f8e0099b3d0f6da41a20bc127b08d37166169066ccab077,1781,158,1993,2,3934,Jeff Davis19d7cedea74d09551f8e0099b3d0f6da41a20bc127b08d37166169066ccab077
Jefferson,19d7cedea74d09551f8e0099b3d0f6da41a20bc127b08d37166169066ccab077,2490,345,2074,12,4921,Jefferson19d7cedea74d09551f8e0099b3d0f6da41a20bc127b08d37166169066ccab077
Jenkins,19d7cedea74d09551f8e0099b3d0f6da41a20bc127b08d37166169066ccab077,965,145,1202,12,2324,Jenkins19d7cedea74d09551f8e0099b3d0f6da41a20bc127b08d37166169066ccab077
Johnson,19d7cedea74d09551f8e0099b3d0f6da41a20bc127b08d37166169066ccab077,1068,175,1357,0,2600,Johnson19d7cedea74d09551f8e0099b3d0f6da41a20bc127b08d37166169066ccab077
Jones,19d7cedea74d09551f8e0099b3d0f6da41a20bc127b08d37166169066ccab077,3658,608,5754,1,10021,Jones19d7cedea74d09551f8e0099b3d0f6da41a20bc127b08d37166169066ccab077
Lamar,19d7cedea74d09551f8e0099b3d0f6da41a20bc127b08d37166169066ccab077,2281,281,3369,9,5940,Lamar19d7cedea74d09551f8e0099b3d0f6da41a20bc127b08d37166169066ccab077
Lanier,19d7cedea74d09551f8e0099b3d0f6da41a20bc127b08d37166169066ccab077,902,62,1278,1,2243,Lanier19d7cedea74d09551f8e0099b3d0f6da41a20bc127b08d37166169066ccab077
Laurens,19d7cedea74d09551f8e0099b3d0f6da41a20bc127b08d37166169066ccab077,7373,898,6396,2,14669,Laurens19d7cedea74d09551f8e0099b3d0f6da41a20bc127b08d37166169066ccab077
Lee,19d7cedea74d09551f8e0099b3d0f6da41a20bc127b08d37166169066ccab077,5566,416,5992,4,11978,Lee19d7cedea74d09551f8e0099b3d0f6da41a20bc127b08d37166169066ccab077
Liberty,19d7cedea74d09551f8e0099b3d0f6da41a20bc127b08d37166169066ccab077,5244,498,7546,32,13320,Liberty19d7cedea74d09551f8e0099b3d0f6da41a20bc127b08d37166169066ccab077
Lincoln,19d7cedea74d09551f8e0099b3d0f6da41a20bc127b08d37166169066ccab077,1219,305,1653,1,3178,Lincoln19d7cedea74d09551f8e0099b3d0f6da41a20bc127b08d37166169066ccab077
Long,19d7cedea74d09551f8e0099b3d0f6da41a20bc127b08d37166169066ccab077,1621,79,1634,5,3339,Long19d7cedea74d09551f8e0099b3d0f6da41a20bc127b08d37166169066ccab077
Lowndes,19d7cedea74d09551f8e0099b3d0f6da41a20bc127b08d37166169066ccab077,9245,1304,19699,407,30655,Lowndes19d7cedea74d09551f8e0099b3d0f6da41a20bc127b08d37166169066ccab077
Lumpkin,19d7cedea74d09551f8e0099b3d0f6da41a20bc127b08d37166169066ccab077,2323,448,7077,5,9853,Lumpkin19d7cedea74d09551f8e0099b3d0f6da41a20bc127b08d37166169066ccab077
Macon,19d7cedea74d09551f8e0099b3d0f6da41a20bc127b08d37166169066ccab077,1297,187,1558,0,3042,Macon19d7cedea74d09551f8e0099b3d0f6da41a20bc127b08d37166169066ccab077
Madison,19d7cedea74d09551f8e0099b3d0f6da41a20bc127b08d37166169066ccab077,4116,402,4772,6,9296,Madison19d7cedea74d09551f8e0099b3d0f6da41a20bc127b08d37166169066ccab077
Marion,19d7cedea74d09551f8e0099b3d0f6da41a20bc127b08d37166169066ccab077,1208,198,945,0,2351,Marion19d7cedea74d09551f8e0099b3d0f6da41a20bc127b08d37166169066ccab077
McDuffie,19d7cedea74d09551f8e0099b3d0f6da41a20bc127b08d37166169066ccab077,2690,464,4245,0,7399,McDuffie19d7cedea74d09551f8e0099b3d0f6da41a20bc127b08d37166169066ccab077
McIntosh,19d7cedea74d09551f8e0099b3d0f6da41a20bc127b08d37166169066ccab077,1626,438,2223,10,4297,McIntosh19d7cedea74d09551f8e0099b3d0f6da41a20bc127b08d37166169066ccab077
Meriwether,19d7cedea74d09551f8e0099b3d0f6da41a20bc127b08d37166169066ccab077,4039,316,2647,4,7006,Meriwether19d7cedea74d09551f8e0099b3d0f6da41a20bc127b08d37166169066ccab077
Miller,19d7cedea74d09551f8e0099b3d0f6da41a20bc127b08d37166169066ccab077,822,126,883,3,1834,Miller19d7cedea74d09551f8e0099b3d0f6da41a20bc127b08d37166169066ccab077
Mitchell,19d7cedea74d09551f8e0099b3d0f6da41a20bc127b08d37166169066ccab077,2739,409,2984,6,6138,Mitchell19d7cedea74d09551f8e0099b3d0f6da41a20bc127b08d37166169066ccab077
Monroe,19d7cedea74d09551f8e0099b3d0f6da41a20bc127b08d37166169066ccab077,4542,446,5119,8,10115,Monroe19d7cedea74d09551f8e0099b3d0f6da41a20bc127b08d37166169066ccab077
Montgomery,19d7cedea74d09551f8e0099b3d0f6da41a20bc127b08d37166169066ccab077,1601,99,983,0,2683,Montgomery19d7cedea74d09551f8e0099b3d0f6da41a20bc127b08d37166169066ccab077
Morgan,19d7cedea74d09551f8e0099b3d0f6da41a20bc127b08d37166169066ccab077,2700,315,4295,3,7313,Morgan19d7cedea74d09551f8e0099b3d0f6da41a20bc127b08d37166169066ccab077
Murray,19d7cedea74d09551f8e0099b3d0f6da41a20bc127b08d37166169066ccab077,5024,300,4390,0,9714,Murray19d7cedea74d09551f8e0099b3d0f6da41a20bc127b08d37166169066ccab077
Muscogee,19d7cedea74d09551f8e0099b3d0f6da41a20bc127b08d37166169066ccab077,24929,3225,27373,85,55612,Muscogee19d7cedea74d09551f8e0099b3d0f6da41a20bc127b08d37166169066ccab077
Newton,19d7cedea74d09551f8e0099b3d0f6da41a20bc127b08d37166169066ccab077,16155,1657,18019,4,35835,Newton19d7cedea74d09551f8e0099b3d0f6da41a20bc127b08d37166169066ccab077
Oconee,19d7cedea74d09551f8e0099b3d0f6da41a20bc127b08d37166169066ccab077,5941,708,9262,7,15918,Oconee19d7cedea74d09551f8e0099b3d0f6da41a20bc127b08d37166169066ccab077
Oglethorpe,19d7cedea74d09551f8e0099b3d0f6da41a20bc127b08d37166169066ccab077,1768,304,3032,2,5106,Oglethorpe19d7cedea74d09551f8e0099b3d0f6da41a20bc127b08d37166169066ccab077
Paulding,19d7cedea74d09551f8e0099b3d0f6da41a20bc127b08d37166169066ccab077,15730,2617,36008,20,54375,Paulding19d7cedea74d09551f8e0099b3d0f6da41a20bc127b08d37166169066ccab077
Peach,19d7cedea74d09551f8e0099b3d0f6da41a20bc127b08d37166169066ccab077,2534,297,5587,18,8436,Peach19d7cedea74d09551f8e0099b3d0f6da41a20bc127b08d37166169066ccab077
Pickens,19d7cedea74d09551f8e0099b3d0f6da41a20bc127b08d37166169066ccab077,4230,234,6523,1,10988,Pickens19d7cedea74d09551f8e0099b3d0f6da41a20bc127b08d37166169066ccab077
Pierce,19d7cedea74d09551f8e0099b3d0f6da41a20bc127b08d37166169066ccab077,1553,294,3677,1,5525,Pierce19d7cedea74d09551f8e0099b3d0f6da41a20bc127b08d37166169066ccab077
Pike,19d7cedea74d09551f8e0099b3d0f6da41a20bc127b08d37166169066ccab077,2568,291,4011,4,6874,Pike19d7cedea74d09551f8e0099b3d0f6da41a20bc127b08d37166169066ccab077
Polk,19d7cedea74d09551f8e0099b3d0f6da41a20bc127b08d37166169066ccab077,3597,395,7350,5,11347,Polk19d7cedea74d09551f8e0099b3d0f6da41a20bc127b08d37166169066ccab077
Pulaski,19d7cedea74d09551f8e0099b3d0f6da41a20bc127b08d37166169066ccab077,682,150,1940,1,2773,Pulaski19d7cedea74d09551f8e0099b3d0f6da41a20bc127b08d37166169066ccab077
Putnam,19d7cedea74d09551f8e0099b3d0f6da41a20bc127b08d37166169066ccab077,2722,470,4111,4,7307,Putnam19d7cedea74d09551f8e0099b3d0f6da41a20bc127b08d37166169066ccab077
Quitman,19d7cedea74d09551f8e0099b3d0f6da41a20bc127b08d37166169066ccab077,327,49,376,0,752,Quitman19d7cedea74d09551f8e0099b3d0f6da41a20bc127b08d37166169066ccab077
Rabun,19d7cedea74d09551f8e0099b3d0f6da41a20bc127b08d37166169066ccab077,1120,734,4477,0,6331,Rabun19d7cedea74d09551f8e0099b3d0f6da41a20bc127b08d37166169066ccab077
Randolph,19d7cedea74d09551f8e0099b3d0f6da41a20bc127b08d37166169066ccab077,1084,132,965,1,2182,Randolph19d7cedea74d09551f8e0099b3d0f6da41a20bc127b08d37166169066ccab077
Richmond,19d7cedea74d09551f8e0099b3d0f6da41a20bc127b08d37166169066ccab077,27992,3717,28748,83,60540,Richmond19d7cedea74d09551f8e0099b3d0f6da41a20bc127b08d37166169066ccab077
Rockdale,19d7cedea74d09551f8e0099b3d0f6da41a20bc127b08d37166169066ccab077,8330,1222,21033,29,30614,Rockdale19d7cedea74d09551f8e0099b3d0f6da41a20bc127b08d37166169066ccab077
Schley,19d7cedea74d09551f8e0099b3d0f6da41a20bc127b08d37166169066ccab077,451,63,942,0,1456,Schley19d7cedea74d09551f8e0099b3d0f6da41a20bc127b08d37166169066ccab077
Screven,19d7cedea74d09551f8e0099b3d0f6da41a20bc127b08d37166169066ccab077,2135,152,2083,0,4370,Screven19d7cedea74d09551f8e0099b3d0f6da41a20bc127b08d37166169066ccab077
Seminole,19d7cedea74d09551f8e0099b3d0f6da41a20bc127b08d37166169066ccab077,1506,138,1092,3,2739,Seminole19d7cedea74d09551f8e0099b3d0f6da41a20bc127b08d37166169066ccab077
Spalding,19d7cedea74d09551f8e0099b3d0f6da41a20bc127b08d37166169066ccab077,7473,875,11716,13,20077,Spalding19d7cedea74d09551f8e0099b3d0f6da41a20bc127b08d37166169066ccab077
Stephens,19d7cedea74d09551f8e0099b3d0f6da41a20bc127b08d37166169066ccab077,1666,533,5778,3,7980,Stephens19d7cedea74d09551f8e0099b3d0f6da41a20bc127b08d37166169066ccab077
Stewart,19d7cedea74d09551f8e0099b3d0f6da41a20bc127b08d37166169066ccab077,620,213,507,4,1344,Stewart19d7cedea74d09551f8e0099b3d0f6da41a20bc127b08d37166169066ccab077
Sumter,19d7cedea74d09551f8e0099b3d0f6da41a20bc127b08d37166169066ccab077,3507,618,4449,1,8575,Sumter19d7cedea74d09551f8e0099b3d0f6da41a20bc127b08d37166169066ccab077
Talbot,19d7cedea74d09551f8e0099b3d0f6da41a20bc127b08d37166169066ccab077,1362,389,627,0,2378,Talbot19d7cedea74d09551f8e0099b3d0f6da41a20bc127b08d37166169066ccab077
Taliaferro,19d7cedea74d09551f8e0099b3d0f6da41a20bc127b08d37166169066ccab077,263,73,281,1,618,Taliaferro19d7cedea74d09551f8e0099b3d0f6da41a20bc127b08d37166169066ccab077
Tattnall,19d7cedea74d09551f8e0099b3d0f6da41a20bc127b08d37166169066ccab077,1982,437,2656,5,5080,Tattnall19d7cedea74d09551f8e0099b3d0f6da41a20bc127b08d37166169066ccab077
Taylor,19d7cedea74d09551f8e0099b3d0f6da41a20bc127b08d37166169066ccab077,951,217,1324,0,2492,Taylor19d7cedea74d09551f8e0099b3d0f6da41a20bc127b08d37166169066ccab077
Telfair,19d7cedea74d09551f8e0099b3d0f6da41a20bc127b08d37166169066ccab077,1392,189,1060,0,2641,Telfair19d7cedea74d09551f8e0099b3d0f6da41a20bc127b08d37166169066ccab077
Terrell,19d7cedea74d09551f8e0099b3d0f6da41a20bc127b08d37166169066ccab077,1454,205,1485,1,3145,Terrell19d7cedea74d09551f8e0099b3d0f6da41a20bc127b08d37166169066ccab077
Thomas,19d7cedea74d09551f8e0099b3d0f6da41a20bc127b08d37166169066ccab077,5673,690,8504,3,14870,Thomas19d7cedea74d09551f8e0099b3d0f6da41a20bc127b08d37166169066ccab077
Tift,19d7cedea74d09551f8e0099b3d0f6da41a20bc127b08d37166169066ccab077,4303,457,6551,12,11323,Tift19d7cedea74d09551f8e0099b3d0f6da41a20bc127b08d37166169066ccab077
Toombs,19d7cedea74d09551f8e0099b3d0f6da41a20bc127b08d37166169066ccab077,2869,488,3775,1,7133,Toombs19d7cedea74d09551f8e0099b3d0f6da41a20bc127b08d37166169066ccab077
Towns,19d7cedea74d09551f8e0099b3d0f6da41a20bc127b08d37166169066ccab077,1412,323,3547,8,5290,Towns19d7cedea74d09551f8e0099b3d0f6da41a20bc127b08d37166169066ccab077
Treutlen,19d7cedea74d09551f8e0099b3d0f6da41a20bc127b08d37166169066ccab077,665,137,1160,2,1964,Treutlen19d7cedea74d09551f8e0099b3d0f6da41a20bc127b08d37166169066ccab077
Troup,19d7cedea74d09551f8e0099b3d0f6da41a20bc127b08d37166169066ccab077,9176,1000,10036,180,20392,Troup19d7cedea74d09551f8e0099b3d0f6da41a20bc127b08d37166169066ccab077
Turner,19d7cedea74d09551f8e0099b3d0f6da41a20bc127b08d37166169066ccab077,894,73,1615,3,2585,Turner19d7cedea74d09551f8e0099b3d0f6da41a20bc127b08d37166169066ccab077
Twiggs,19d7cedea74d09551f8e0099b3d0f6da41a20bc127b08d37166169066ccab077,1564,212,1150,1,2927,Twiggs19d7cedea74d09551f8e0099b3d0f6da41a20bc127b08d37166169066ccab077
Union,19d7cedea74d09551f8e0099b3d0f6da41a20bc127b08d37166169066ccab077,3068,523,5897,0,9488,Union19d7cedea74d09551f8e0099b3d0f6da41a20bc127b08d37166169066ccab077
Upson,19d7cedea74d09551f8e0099b3d0f6da41a20bc127b08d37166169066ccab077,2357,395,5803,5,8560,Upson19d7cedea74d09551f8e0099b3d0f6da41a20bc127b08d37166169066ccab077
Walker,19d7cedea74d09551f8e0099b3d0f6da41a20bc127b08d37166169066ccab077,7907,816,11146,11,19880,Walker19d7cedea74d09551f8e0099b3d0f6da41a20bc127b08d37166169066ccab077
Walton,19d7cedea74d09551f8e0099b3d0f6da41a20bc127b08d37166169066ccab077,16897,1442,14885,29,33253,Walton19d7cedea74d09551f8e0099b3d0f6da41a20bc127b08d37166169066ccab077
Ware,19d7cedea74d09551f8e0099b3d0f6da41a20bc127b08d37166169066ccab077,3710,464,5264,4,9442,Ware19d7cedea74d09551f8e0099b3d0f6da41a20bc127b08d37166169066ccab077
Warren,19d7cedea74d09551f8e0099b3d0f6da41a20bc127b08d37166169066ccab077,665,107,833,1,1606,Warren19d7cedea74d09551f8e0099b3d0f6da41a20bc127b08d37166169066ccab077
Washington,19d7cedea74d09551f8e0099b3d0f6da41a20bc127b08d37166169066ccab077,2624,563,3061,14,6262,Washington19d7cedea74d09551f8e0099b3d0f6da41a20bc127b08d37166169066ccab077
Wayne,19d7cedea74d09551f8e0099b3d0f6da41a20bc127b08d37166169066ccab077,3399,318,4378,7,8102,Wayne19d7cedea74d09551f8e0099b3d0f6da41a20bc127b08d37166169066ccab077
Webster,19d7cedea74d09551f8e0099b3d0f6da41a20bc127b08d37166169066ccab077,355,94,383,0,832,Webster19d7cedea74d09551f8e0099b3d0f6da41a20bc127b08d37166169066ccab077
Wheeler,19d7cedea74d09551f8e0099b3d0f6da41a20bc127b08d37166169066ccab077,731,121,675,3,1530,Wheeler19d7cedea74d09551f8e0099b3d0f6da41a20bc127b08d37166169066ccab077
White,19d7cedea74d09551f8e0099b3d0f6da41a20bc127b08d37166169066ccab077,3851,528,5127,9,9515,White19d7cedea74d09551f8e0099b3d0f6da41a20bc127b08d37166169066ccab077
Whitfield,19d7cedea74d09551f8e0099b3d0f6da41a20bc127b08d37166169066ccab077,12403,968,10549,26,23946,Whitfield19d7cedea74d09551f8e0099b3d0f6da41a20bc127b08d37166169066ccab077
Wilcox,19d7cedea74d09551f8e0099b3d0f6da41a20bc127b08d37166169066ccab077,1129,173,924,0,2226,Wilcox19d7cedea74d09551f8e0099b3d0f6da41a20bc127b08d37166169066ccab077
Wilkes,19d7cedea74d09551f8e0099b3d0f6da41a20bc127b08d37166169066ccab077,1562,142,1505,5,3214,Wilkes19d7cedea74d09551f8e0099b3d0f6da41a20bc127b08d37166169066ccab077
Wilkinson,19d7cedea74d09551f8e0099b3d0f6da41a20bc127b08d37166169066ccab077,1898,161,1135,3,3197,Wilkinson19d7cedea74d09551f8e0099b3d0f6da41a20bc127b08d37166169066ccab077
Worth,19d7cedea74d09551f8e0099b3d0f6da41a20bc127b08d37166169066ccab077,3439,218,2832,9,6498,Worth19d7cedea74d09551f8e0099b3d0f6da41a20bc127b08d37166169066ccab077
Appling,1bf1effec454d01e8804893fee773045295622ce4aab3dc304dadb6b9b5255d5,673,62,470,0,1205,Appling1bf1effec454d01e8804893fee773045295622ce4aab3dc304dadb6b9b5255d5
Atkinson,1bf1effec454d01e8804893fee773045295622ce4aab3dc304dadb6b9b5255d5,216,9,260,0,485,Atkinson1bf1effec454d01e8804893fee773045295622ce4aab3dc304dadb6b9b5255d5
Bacon,1bf1effec454d01e8804893fee773045295622ce4aab3dc304dadb6b9b5255d5,231,16,320,0,567,Bacon1bf1effec454d01e8804893fee773045295622ce4aab3dc304dadb6b9b5255d5
Baker,1bf1effec454d01e8804893fee773045295622ce4aab3dc304dadb6b9b5255d5,164,27,117,0,308,Baker1bf1effec454d01e8804893fee773045295622ce4aab3dc304dadb6b9b5255d5
Baldwin,1bf1effec454d01e8804893fee773045295622ce4aab3dc304dadb6b9b5255d5,1172,139,1477,3,2791,Baldwin1bf1effec454d01e8804893fee773045295622ce4aab3dc304dadb6b9b5255d5
Banks,1bf1effec454d01e8804893fee773045295622ce4aab3dc304dadb6b9b5255d5,630,32,533,0,1195,Banks1bf1effec454d01e8804893fee773045295622ce4aab3dc304dadb6b9b5255d5
Barrow,1bf1effec454d01e8804893fee773045295622ce4aab3dc304dadb6b9b5255d5,1950,139,2316,0,4405,Barrow1bf1effec454d01e8804893fee773045295622ce4aab3dc304dadb6b9b5255d5
Bartow,1bf1effec454d01e8804893fee773045295622ce4aab3dc304dadb6b9b5255d5,3516,196,2637,2,6351,Bartow1bf1effec454d01e8804893fee773045295622ce4aab3dc304dadb6b9b5255d5
Ben Hill,1bf1effec454d01e8804893fee773045295622ce4aab3dc304dadb6b9b5255d5,311,43,819,1,1174,Ben Hill1bf1effec454d01e8804893fee773045295622ce4aab3dc304dadb6b9b5255d5
Berrien,1bf1effec454d01e8804893fee773045295622ce4aab3dc304dadb6b9b5255d5,456,43,467,4,970,Berrien1bf1effec454d01e8804893fee773045295622ce4aab3dc304dadb6b9b5255d5
Bibb,1bf1effec454d01e8804893fee773045295622ce4aab3dc304dadb6b9b5255d5,5363,531,5066,39,10999,Bibb1bf1effec454d01e8804893fee773045295622ce4aab3dc304dadb6b9b5255d5
Bleckley,1bf1effec454d01e8804893fee773045295622ce4aab3dc304dadb6b9b5255d5,348,32,379,1,760,Bleckley1bf1effec454d01e8804893fee773045295622ce4aab3dc304dadb6b9b5255d5
Brantley,1bf1effec454d01e8804893fee773045295622ce4aab3dc304dadb6b9b5255d5,532,34,487,0,1053,Brantley1bf1effec454d01e8804893fee773045295622ce4aab3dc304dadb6b9b5255d5
Brooks,1bf1effec454d01e8804893fee773045295622ce4aab3dc304dadb6b9b5255d5,501,92,435,8,1036,Brooks1bf1effec454d01e8804893fee773045295622ce4aab3dc304dadb6b9b5255d5
Bryan,1bf1effec454d01e8804893fee773045295622ce4aab3dc304dadb6b9b5255d5,697,58,1021,0,1776,Bryan1bf1effec454d01e8804893fee773045295622ce4aab3dc304dadb6b9b5255d5
Bulloch,1bf1effec454d01e8804893fee773045295622ce4aab3dc304dadb6b9b5255d5,2032,152,2149,7,4340,Bulloch1bf1effec454d01e8804893fee773045295622ce4aab3dc304dadb6b9b5255d5
Burke,1bf1effec454d01e8804893fee773045295622ce4aab3dc304dadb6b9b5255d5,841,131,560,0,1532,Burke1bf1effec454d01e8804893fee773045295622ce4aab3dc304dadb6b9b5255d5
Butts,1bf1effec454d01e8804893fee773045295622ce4aab3dc304dadb6b9b5255d5,400,29,1021,0,1450,Butts1bf1effec454d01e8804893fee773045295622ce4aab3dc304dadb6b9b5255d5
Calhoun,1bf1effec454d01e8804893fee773045295622ce4aab3dc304dadb6b9b5255d5,323,33,142,0,498,Calhoun1bf1effec454d01e8804893fee773045295622ce4aab3dc304dadb6b9b5255d5
Camden,1bf1effec454d01e8804893fee773045295622ce4aab3dc304dadb6b9b5255d5,1177,140,1546,1,2864,Camden1bf1effec454d01e8804893fee773045295622ce4aab3dc304dadb6b9b5255d5
Candler,1bf1effec454d01e8804893fee773045295622ce4aab3dc304dadb6b9b5255d5,158,12,413,0,583,Candler1bf1effec454d01e8804893fee773045295622ce4aab3dc304dadb6b9b5255d5
Carroll,1bf1effec454d01e8804893fee773045295622ce4aab3dc304dadb6b9b5255d5,3070,195,3760,9,7034,Carroll1bf1effec454d01e8804893fee773045295622ce4aab3dc304dadb6b9b5255d5
Catoosa,1bf1effec454d01e8804893fee773045295622ce4aab3dc304dadb6b9b5255d5,1263,71,2131,0,3465,Catoosa1bf1effec454d01e8804893fee773045295622ce4aab3dc304dadb6b9b5255d5
Charlton,1bf1effec454d01e8804893fee773045295622ce4aab3dc304dadb6b9b5255d5,324,27,376,1,728,Charlton1bf1effec454d01e8804893fee773045295622ce4aab3dc304dadb6b9b5255d5
Chatham,1bf1effec454d01e8804893fee773045295622ce4aab3dc304dadb6b9b5255d5,12378,562,5557,15,18512,Chatham1bf1effec454d01e8804893fee773045295622ce4aab3dc304dadb6b9b5255d5
Chattahoochee,1bf1effec454d01e8804893fee773045295622ce4aab3dc304dadb6b9b5255d5,104,2,94,0,200,Chattahoochee1bf1effec454d01e8804893fee773045295622ce4aab3dc304dadb6b9b5255d5
Chattooga,1bf1effec454d01e8804893fee773045295622ce4aab3dc304dadb6b9b5255d5,688,25,645,1,1359,Chattooga1bf1effec454d01e8804893fee773045295622ce4aab3dc304dadb6b9b5255d5
Cherokee,1bf1effec454d01e8804893fee773045295622ce4aab3dc304dadb6b9b5255d5,7346,665,9026,2,17039,Cherokee1bf1effec454d01e8804893fee773045295622ce4aab3dc304dadb6b9b5255d5
Clarke,1bf1effec454d01e8804893fee773045295622ce4aab3dc304dadb6b9b5255d5,4818,446,6261,20,11545,Clarke1bf1effec454d01e8804893fee773045295622ce4aab3dc304dadb6b9b5255d5
Clay,1bf1effec454d01e8804893fee773045295622ce4aab3dc304dadb6b9b5255d5,127,18,116,0,261,Clay1bf1effec454d01e8804893fee773045295622ce4aab3dc304dadb6b9b5255d5
Clayton,1bf1effec454d01e8804893fee773045295622ce4aab3dc304dadb6b9b5255d5,5301,348,7506,22,13177,Clayton1bf1effec454d01e8804893fee773045295622ce4aab3dc304dadb6b9b5255d5
Clinch,1bf1effec454d01e8804893fee773045295622ce4aab3dc304dadb6b9b5255d5,147,11,204,0,362,Clinch1bf1effec454d01e8804893fee773045295622ce4aab3dc304dadb6b9b5255d5
Cobb,1bf1effec454d01e8804893fee773045295622ce4aab3dc304dadb6b9b5255d5,29697,3168,22504,117,55486,Cobb1bf1effec454d01e8804893fee773045295622ce4aab3dc304dadb6b9b5255d5
Coffee,1bf1effec454d01e8804893fee773045295622ce4aab3dc304dadb6b9b5255d5,917,72,1443,0,2432,Coffee1bf1effec454d01e8804893fee773045295622ce4aab3dc304dadb6b9b5255d5
Colquitt,1bf1effec454d01e8804893fee773045295622ce4aab3dc304dadb6b9b5255d5,1056,58,927,0,2041,Colquitt1bf1effec454d01e8804893fee773045295622ce4aab3dc304dadb6b9b5255d5
Columbia,1bf1effec454d01e8804893fee773045295622ce4aab3dc304dadb6b9b5255d5,3389,331,4172,1,7893,Columbia1bf1effec454d01e8804893fee773045295622ce4aab3dc304dadb6b9b5255d5
Cook,1bf1effec454d01e8804893fee773045295622ce4aab3dc304dadb6b9b5255d5,460,29,482,0,971,Cook1bf1effec454d01e8804893fee773045295622ce4aab3dc304dadb6b9b5255d5
Coweta,1bf1effec454d01e8804893fee773045295622ce4aab3dc304dadb6b9b5255d5,4798,368,4986,3,10155,Coweta1bf1effec454d01e8804893fee773045295622ce4aab3dc304dadb6b9b5255d5
Crawford,1bf1effec454d01e8804893fee773045295622ce4aab3dc304dadb6b9b5255d5,379,35,485,1,900,Crawford1bf1effec454d01e8804893fee773045295622ce4aab3dc304dadb6b9b5255d5
Crisp,1bf1effec454d01e8804893fee773045295622ce4aab3dc304dadb6b9b5255d5,384,51,720,1,1156,Crisp1bf1effec454d01e8804893fee773045295622ce4aab3dc304dadb6b9b5255d5
Dade,1bf1effec454d01e8804893fee773045295622ce4aab3dc304dadb6b9b5255d5,417,17,394,0,828,Dade1bf1effec454d01e8804893fee773045295622ce4aab3dc304dadb6b9b5255d5
Dawson,1bf1effec454d01e8804893fee773045295622ce4aab3dc304dadb6b9b5255d5,480,81,1293,0,1854,Dawson1bf1effec454d01e8804893fee773045295622ce4aab3dc304dadb6b9b5255d5
Decatur,1bf1effec454d01e8804893fee773045295622ce4aab3dc304dadb6b9b5255d5,842,69,1119,7,2037,Decatur1bf1effec454d01e8804893fee773045295622ce4aab3dc304dadb6b9b5255d5
DeKalb,1bf1effec454d01e8804893fee773045295622ce4aab3dc304dadb6b9b5255d5,23906,2087,29284,94,55371,DeKalb1bf1effec454d01e8804893fee773045295622ce4aab3dc304dadb6b9b5255d5
Dodge,1bf1effec454d01e8804893fee773045295622ce4aab3dc304dadb6b9b5255d5,748,54,555,0,1357,Dodge1bf1effec454d01e8804893fee773045295622ce4aab3dc304dadb6b9b5255d5
Dooly,1bf1effec454d01e8804893fee773045295622ce4aab3dc304dadb6b9b5255d5,372,21,298,4,695,Dooly1bf1effec454d01e8804893fee773045295622ce4aab3dc304dadb6b9b5255d5
Dougherty,1bf1effec454d01e8804893fee773045295622ce4aab3dc304dadb6b9b5255d5,3438,194,2287,18,5937,Dougherty1bf1effec454d01e8804893fee773045295622ce4aab3dc304dadb6b9b5255d5
Douglas,1bf1effec454d01e8804893fee773045295622ce4aab3dc304dadb6b9b5255d5,3194,311,5642,6,9153,Douglas1bf1effec454d01e8804893fee773045295622ce4aab3dc304dadb6b9b5255d5
Early,1bf1effec454d01e8804893fee773045295622ce4aab3dc304dadb6b9b5255d5,504,54,400,0,958,Early1bf1effec454d01e8804893fee773045295622ce4aab3dc304dadb6b9b5255d5
Echols,1bf1effec454d01e8804893fee773045295622ce4aab3dc304dadb6b9b5255d5,74,9,91,0,174,Echols1bf1effec454d01e8804893fee773045295622ce4aab3dc304dadb6b9b5255d5
Effingham,1bf1effec454d01e8804893fee773045295622ce4aab3dc304dadb6b9b5255d5,1443,69,1432,1,2945,Effingham1bf1effec454d01e8804893fee773045295622ce4aab3dc304dadb6b9b5255d5
Elbert,1bf1effec454d01e8804893fee773045295622ce4aab3dc304dadb6b9b5255d5,557,64,745,7,1373,Elbert1bf1effec454d01e8804893fee773045295622ce4aab3dc304dadb6b9b5255d5
Emanuel,1bf1effec454d01e8804893fee773045295622ce4aab3dc304dadb6b9b5255d5,673,49,506,0,1228,Emanuel1bf1effec454d01e8804893fee773045295622ce4aab3dc304dadb6b9b5255d5
Evans,1bf1effec454d01e8804893fee773045295622ce4aab3dc304dadb6b9b5255d5,200,32,421,0,653,Evans1bf1effec454d01e8804893fee773045295622ce4aab3dc304dadb6b9b5255d5
Fannin,1bf1effec454d01e8804893fee773045295622ce4aab3dc304dadb6b9b5255d5,873,123,879,2,1877,Fannin1bf1effec454d01e8804893fee773045295622ce4aab3dc304dadb6b9b5255d5
Fayette,1bf1effec454d01e8804893fee773045295622ce4aab3dc304dadb6b9b5255d5,3711,384,6521,3,10619,Fayette1bf1effec454d01e8804893fee773045295622ce4aab3dc304dadb6b9b5255d5
Floyd,1bf1effec454d01e8804893fee773045295622ce4aab3dc304dadb6b9b5255d5,2422,167,3116,10,5715,Floyd1bf1effec454d01e8804893fee773045295622ce4aab3dc304dadb6b9b5255d5
Forsyth,1bf1effec454d01e8804893fee773045295622ce4aab3dc304dadb6b9b5255d5,3851,451,9400,3,13705,Forsyth1bf1effec454d01e8804893fee773045295622ce4aab3dc304dadb6b9b5255d5
Franklin,1bf1effec454d01e8804893fee773045295622ce4aab3dc304dadb6b9b5255d5,647,51,654,0,1352,Franklin1bf1effec454d01e8804893fee773045295622ce4aab3dc304dadb6b9b5255d5
Fulton,1bf1effec454d01e8804893fee773045295622ce4aab3dc304dadb6b9b5255d5,29212,2605,38405,201,70423,Fulton1bf1effec454d01e8804893fee773045295622ce4aab3dc304dadb6b9b5255d5
Gilmer,1bf1effec454d01e8804893fee773045295622ce4aab3dc304dadb6b9b5255d5,1044,79,1130,2,2255,Gilmer1bf1effec454d01e8804893fee773045295622ce4aab3dc304dadb6b9b5255d5
Glascock,1bf1effec454d01e8804893fee773045295622ce4aab3dc304dadb6b9b5255d5,83,9,72,0,164,Glascock1bf1effec454d01e8804893fee773045295622ce4aab3dc304dadb6b9b5255d5
Glynn,1bf1effec454d01e8804893fee773045295622ce4aab3dc304dadb6b9b5255d5,2268,203,2702,10,5183,Glynn1bf1effec454d01e8804893fee773045295622ce4aab3dc304dadb6b9b5255d5
Gordon,1bf1effec454d01e8804893fee773045295622ce4aab3dc304dadb6b9b5255d5,1448,80,1287,5,2820,Gordon1bf1effec454d01e8804893fee773045295622ce4aab3dc304dadb6b9b5255d5
Grady,1bf1effec454d01e8804893fee773045295622ce4aab3dc304dadb6b9b5255d5,738,46,935,2,1721,Grady1bf1effec454d01e8804893fee773045295622ce4aab3dc304dadb6b9b5255d5
Greene,1bf1effec454d01e8804893fee773045295622ce4aab3dc304dadb6b9b5255d5,510,146,862,1,1519,Greene1bf1effec454d01e8804893fee773045295622ce4aab3dc304dadb6b9b5255d5
Gwinnett,1bf1effec454d01e8804893fee773045295622ce4aab3dc304dadb6b9b5255d5,24215,2220,20108,155,46698,Gwinnett1bf1effec454d01e8804893fee773045295622ce4aab3dc304dadb6b9b5255d5
Habersham,1bf1effec454d01e8804893fee773045295622ce4aab3dc304dadb6b9b5255d5,491,111,1726,0,2328,Habersham1bf1effec454d01e8804893fee773045295622ce4aab3dc304dadb6b9b5255d5
Hall,1bf1effec454d01e8804893fee773045295622ce4aab3dc304dadb6b9b5255d5,5256,486,5212,6,10960,Hall1bf1effec454d01e8804893fee773045295622ce4aab3dc304dadb6b9b5255d5
Hancock,1bf1effec454d01e8804893fee773045295622ce4aab3dc304dadb6b9b5255d5,396,43,308,0,747,Hancock1bf1effec454d01e8804893fee773045295622ce4aab3dc304dadb6b9b5255d5
Haralson,1bf1effec454d01e8804893fee773045295622ce4aab3dc304dadb6b9b5255d5,964,61,787,1,1813,Haralson1bf1effec454d01e8804893fee773045295622ce4aab3dc304dadb6b9b5255d5
Harris,1bf1effec454d01e8804893fee773045295622ce4aab3dc304dadb6b9b5255d5,995,71,1119,0,2185,Harris1bf1effec454d01e8804893fee773045295622ce4aab3dc304dadb6b9b5255d5
Hart,1bf1effec454d01e8804893fee773045295622ce4aab3dc304dadb6b9b5255d5,698,56,970,0,1724,Hart1bf1effec454d01e8804893fee773045295622ce4aab3dc304dadb6b9b5255d5
Heard,1bf1effec454d01e8804893fee773045295622ce4aab3dc304dadb6b9b5255d5,378,45,275,0,698,Heard1bf1effec454d01e8804893fee773045295622ce4aab3dc304dadb6b9b5255d5
Henry,1bf1effec454d01e8804893fee773045295622ce4aab3dc304dadb6b9b5255d5,4190,428,9668,30,14316,Henry1bf1effec454d01e8804893fee773045295622ce4aab3dc304dadb6b9b5255d5
Houston,1bf1effec454d01e8804893fee773045295622ce4aab3dc304dadb6b9b5255d5,3109,343,6128,12,9592,Houston1bf1effec454d01e8804893fee773045295622ce4aab3dc304dadb6b9b5255d5
Irwin,1bf1effec454d01e8804893fee773045295622ce4aab3dc304dadb6b9b5255d5,399,14,353,0,766,Irwin1bf1effec454d01e8804893fee773045295622ce4aab3dc304dadb6b9b5255d5
Jackson,1bf1effec454d01e8804893fee773045295622ce4aab3dc304dadb6b9b5255d5,1663,96,2840,2,4601,Jackson1bf1effec454d01e8804893fee773045295622ce4aab3dc304dadb6b9b5255d5
Jasper,1bf1effec454d01e8804893fee773045295622ce4aab3dc304dadb6b9b5255d5,397,58,517,0,972,Jasper1bf1effec454d01e8804893fee773045295622ce4aab3dc304dadb6b9b5255d5
Jeff Davis,1bf1effec454d01e8804893fee773045295622ce4aab3dc304dadb6b9b5255d5,320,26,321,0,667,Jeff Davis1bf1effec454d01e8804893fee773045295622ce4aab3dc304dadb6b9b5255d5
Jefferson,1bf1effec454d01e8804893fee773045295622ce4aab3dc304dadb6b9b5255d5,756,87,569,0,1412,Jefferson1bf1effec454d01e8804893fee773045295622ce4aab3dc304dadb6b9b5255d5
Jenkins,1bf1effec454d01e8804893fee773045295622ce4aab3dc304dadb6b9b5255d5,208,18,243,4,473,Jenkins1bf1effec454d01e8804893fee773045295622ce4aab3dc304dadb6b9b5255d5
Johnson,1bf1effec454d01e8804893fee773045295622ce4aab3dc304dadb6b9b5255d5,279,37,387,0,703,Johnson1bf1effec454d01e8804893fee773045295622ce4aab3dc304dadb6b9b5255d5
Jones,1bf1effec454d01e8804893fee773045295622ce4aab3dc304dadb6b9b5255d5,820,95,1171,0,2086,Jones1bf1effec454d01e8804893fee773045295622ce4aab3dc304dadb6b9b5255d5
Lamar,1bf1effec454d01e8804893fee773045295622ce4aab3dc304dadb6b9b5255d5,563,60,764,1,1388,Lamar1bf1effec454d01e8804893fee773045295622ce4aab3dc304dadb6b9b5255d5
Lanier,1bf1effec454d01e8804893fee773045295622ce4aab3dc304dadb6b9b5255d5,199,7,244,0,450,Lanier1bf1effec454d01e8804893fee773045295622ce4aab3dc304dadb6b9b5255d5
Laurens,1bf1effec454d01e8804893fee773045295622ce4aab3dc304dadb6b9b5255d5,1992,185,1701,0,3878,Laurens1bf1effec454d01e8804893fee773045295622ce4aab3dc304dadb6b9b5255d5
Lee,1bf1effec454d01e8804893fee773045295622ce4aab3dc304dadb6b9b5255d5,908,62,915,1,1886,Lee1bf1effec454d01e8804893fee773045295622ce4aab3dc304dadb6b9b5255d5
Liberty,1bf1effec454d01e8804893fee773045295622ce4aab3dc304dadb6b9b5255d5,907,73,1336,4,2320,Liberty1bf1effec454d01e8804893fee773045295622ce4aab3dc304dadb6b9b5255d5
Lincoln,1bf1effec454d01e8804893fee773045295622ce4aab3dc304dadb6b9b5255d5,293,59,328,0,680,Lincoln1bf1effec454d01e8804893fee773045295622ce4aab3dc304dadb6b9b5255d5
Long,1bf1effec454d01e8804893fee773045295622ce4aab3dc304dadb6b9b5255d5,320,9,231,1,561,Long1bf1effec454d01e8804893fee773045295622ce4aab3dc304dadb6b9b5255d5
Lowndes,1bf1effec454d01e8804893fee773045295622ce4aab3dc304dadb6b9b5255d5,1968,161,3744,89,5962,Lowndes1bf1effec454d01e8804893fee773045295622ce4aab3dc304dadb6b9b5255d5
Lumpkin,1bf1effec454d01e8804893fee773045295622ce4aab3dc304dadb6b9b5255d5,489,91,1694,2,2276,Lumpkin1bf1effec454d01e8804893fee773045295622ce4aab3dc304dadb6b9b5255d5
Macon,1bf1effec454d01e8804893fee773045295622ce4aab3dc304dadb6b9b5255d5,383,36,393,0,812,Macon1bf1effec454d01e8804893fee773045295622ce4aab3dc304dadb6b9b5255d5
Madison,1bf1effec454d01e8804893fee773045295622ce4aab3dc304dadb6b9b5255d5,986,75,1164,0,2225,Madison1bf1effec454d01e8804893fee773045295622ce4aab3dc304dadb6b9b5255d5
Marion,1bf1effec454d01e8804893fee773045295622ce4aab3dc304dadb6b9b5255d5,315,34,265,0,614,Marion1bf1effec454d01e8804893fee773045295622ce4aab3dc304dadb6b9b5255d5
McDuffie,1bf1effec454d01e8804893fee773045295622ce4aab3dc304dadb6b9b5255d5,555,81,840,0,1476,McDuffie1bf1effec454d01e8804893fee773045295622ce4aab3dc304dadb6b9b5255d5
McIntosh,1bf1effec454d01e8804893fee773045295622ce4aab3dc304dadb6b9b5255d5,509,114,643,0,1266,McIntosh1bf1effec454d01e8804893fee773045295622ce4aab3dc304dadb6b9b5255d5
Meriwether,1bf1effec454d01e8804893fee773045295622ce4aab3dc304dadb6b9b5255d5,1046,63,635,2,1746,Meriwether1bf1effec454d01e8804893fee773045295622ce4aab3dc304dadb6b9b5255d5
Miller,1bf1effec454d01e8804893fee773045295622ce4aab3dc304dadb6b9b5255d5,213,14,203,1,431,Miller1bf1effec454d01e8804893fee773045295622ce4aab3dc304dadb6b9b5255d5
Mitchell,1bf1effec454d01e8804893fee773045295622ce4aab3dc304dadb6b9b5255d5,684,152,644,2,1482,Mitchell1bf1effec454d01e8804893fee773045295622ce4aab3dc304dadb6b9b5255d5
Monroe,1bf1effec454d01e8804893fee773045295622ce4aab3dc304dadb6b9b5255d5,991,82,1039,2,2114,Monroe1bf1effec454d01e8804893fee773045295622ce4aab3dc304dadb6b9b5255d5
Montgomery,1bf1effec454d01e8804893fee773045295622ce4aab3dc304dadb6b9b5255d5,394,18,241,0,653,Montgomery1bf1effec454d01e8804893fee773045295622ce4aab3dc304dadb6b9b5255d5
Morgan,1bf1effec454d01e8804893fee773045295622ce4aab3dc304dadb6b9b5255d5,703,48,1060,1,1812,Morgan1bf1effec454d01e8804893fee773045295622ce4aab3dc304dadb6b9b5255d5
Murray,1bf1effec454d01e8804893fee773045295622ce4aab3dc304dadb6b9b5255d5,942,39,822,0,1803,Murray1bf1effec454d01e8804893fee773045295622ce4aab3dc304dadb6b9b5255d5
Muscogee,1bf1effec454d01e8804893fee773045295622ce4aab3dc304dadb6b9b5255d5,5136,434,5244,27,10841,Muscogee1bf1effec454d01e8804893fee773045295622ce4aab3dc304dadb6b9b5255d5
Newton,1bf1effec454d01e8804893fee773045295622ce4aab3dc304dadb6b9b5255d5,3286,262,3080,0,6628,Newton1bf1effec454d01e8804893fee773045295622ce4aab3dc304dadb6b9b5255d5
Oconee,1bf1effec454d01e8804893fee773045295622ce4aab3dc304dadb6b9b5255d5,1523,139,2110,1,3773,Oconee1bf1effec454d01e8804893fee773045295622ce4aab3dc304dadb6b9b5255d5
Oglethorpe,1bf1effec454d01e8804893fee773045295622ce4aab3dc304dadb6b9b5255d5,510,51,760,0,1321,Oglethorpe1bf1effec454d01e8804893fee773045295622ce4aab3dc304dadb6b9b5255d5
Paulding,1bf1effec454d01e8804893fee773045295622ce4aab3dc304dadb6b9b5255d5,2850,354,5858,5,9067,Paulding1bf1effec454d01e8804893fee773045295622ce4aab3dc304dadb6b9b5255d5
Peach,1bf1effec454d01e8804893fee773045295622ce4aab3dc304dadb6b9b5255d5,608,54,1222,4,1888,Peach1bf1effec454d01e8804893fee773045295622ce4aab3dc304dadb6b9b5255d5
Pickens,1bf1effec454d01e8804893fee773045295622ce4aab3dc304dadb6b9b5255d5,879,32,1511,1,2423,Pickens1bf1effec454d01e8804893fee773045295622ce4aab3dc304dadb6b9b5255d5
Pierce,1bf1effec454d01e8804893fee773045295622ce4aab3dc304dadb6b9b5255d5,393,39,984,0,1416,Pierce1bf1effec454d01e8804893fee773045295622ce4aab3dc304dadb6b9b5255d5
Pike,1bf1effec454d01e8804893fee773045295622ce4aab3dc304dadb6b9b5255d5,579,67,943,1,1590,Pike1bf1effec454d01e8804893fee773045295622ce4aab3dc304dadb6b9b5255d5
Polk,1bf1effec454d01e8804893fee773045295622ce4aab3dc304dadb6b9b5255d5,726,56,1445,1,2228,Polk1bf1effec454d01e8804893fee773045295622ce4aab3dc304dadb6b9b5255d5
Pulaski,1bf1effec454d01e8804893fee773045295622ce4aab3dc304dadb6b9b5255d5,145,29,390,0,564,Pulaski1bf1effec454d01e8804893fee773045295622ce4aab3dc304dadb6b9b5255d5
Putnam,1bf1effec454d01e8804893fee773045295622ce4aab3dc304dadb6b9b5255d5,655,105,1043,1,1804,Putnam1bf1effec454d01e8804893fee773045295622ce4aab3dc304dadb6b9b5255d5
Quitman,1bf1effec454d01e8804893fee773045295622ce4aab3dc304dadb6b9b5255d5,109,2,82,0,193,Quitman1bf1effec454d01e8804893fee773045295622ce4aab3dc304dadb6b9b5255d5
Rabun,1bf1effec454d01e8804893fee773045295622ce4aab3dc304dadb6b9b5255d5,226,113,944,0,1283,Rabun1bf1effec454d01e8804893fee773045295622ce4aab3dc304dadb6b9b5255d5
Randolph,1bf1effec454d01e8804893fee773045295622ce4aab3dc304dadb6b9b5255d5,254,18,209,1,482,Randolph1bf1effec454d01e8804893fee773045295622ce4aab3dc304dadb6b9b5255d5
Richmond,1bf1effec454d01e8804893fee773045295622ce4aab3dc304dadb6b9b5255d5,5903,530,5613,15,12061,Richmond1bf1effec454d01e8804893fee773045295622ce4aab3dc304dadb6b9b5255d5
Rockdale,1bf1effec454d01e8804893fee773045295622ce4aab3dc304dadb6b9b5255d5,1804,165,4155,1,6125,Rockdale1bf1effec454d01e8804893fee773045295622ce4aab3dc304dadb6b9b5255d5
Schley,1bf1effec454d01e8804893fee773045295622ce4aab3dc304dadb6b9b5255d5,113,14,218,0,345,Schley1bf1effec454d01e8804893fee773045295622ce4aab3dc304dadb6b9b5255d5
Screven,1bf1effec454d01e8804893fee773045295622ce4aab3dc304dadb6b9b5255d5,509,15,503,0,1027,Screven1bf1effec454d01e8804893fee773045295622ce4aab3dc304dadb6b9b5255d5
Seminole,1bf1effec454d01e8804893fee773045295622ce4aab3dc304dadb6b9b5255d5,354,30,222,0,606,Seminole1bf1effec454d01e8804893fee773045295622ce4aab3dc304dadb6b9b5255d5
Spalding,1bf1effec454d01e8804893fee773045295622ce4aab3dc304dadb6b9b5255d5,1696,143,2580,2,4421,Spalding1bf1effec454d01e8804893fee773045295622ce4aab3dc304dadb6b9b5255d5
Stephens,1bf1effec454d01e8804893fee773045295622ce4aab3dc304dadb6b9b5255d5,285,68,1043,0,1396,Stephens1bf1effec454d01e8804893fee773045295622ce4aab3dc304dadb6b9b5255d5
Stewart,1bf1effec454d01e8804893fee773045295622ce4aab3dc304dadb6b9b5255d5,193,47,122,0,362,Stewart1bf1effec454d01e8804893fee773045295622ce4aab3dc304dadb6b9b5255d5
Sumter,1bf1effec454d01e8804893fee773045295622ce4aab3dc304dadb6b9b5255d5,868,89,993,0,1950,Sumter1bf1effec454d01e8804893fee773045295622ce4aab3dc304dadb6b9b5255d5
Talbot,1bf1effec454d01e8804893fee773045295622ce4aab3dc304dadb6b9b5255d5,338,65,133,0,536,Talbot1bf1effec454d01e8804893fee773045295622ce4aab3dc304dadb6b9b5255d5
Taliaferro,1bf1effec454d01e8804893fee773045295622ce4aab3dc304dadb6b9b5255d5,71,11,73,0,155,Taliaferro1bf1effec454d01e8804893fee773045295622ce4aab3dc304dadb6b9b5255d5
Tattnall,1bf1effec454d01e8804893fee773045295622ce4aab3dc304dadb6b9b5255d5,549,82,757,1,1389,Tattnall1bf1effec454d01e8804893fee773045295622ce4aab3dc304dadb6b9b5255d5
Taylor,1bf1effec454d01e8804893fee773045295622ce4aab3dc304dadb6b9b5255d5,325,37,331,0,693,Taylor1bf1effec454d01e8804893fee773045295622ce4aab3dc304dadb6b9b5255d5
Telfair,1bf1effec454d01e8804893fee773045295622ce4aab3dc304dadb6b9b5255d5,413,61,292,1,767,Telfair1bf1effec454d01e8804893fee773045295622ce4aab3dc304dadb6b9b5255d5
Terrell,1bf1effec454d01e8804893fee773045295622ce4aab3dc304dadb6b9b5255d5,414,39,340,1,794,Terrell1bf1effec454d01e8804893fee773045295622ce4aab3dc304dadb6b9b5255d5
Thomas,1bf1effec454d01e8804893fee773045295622ce4aab3dc304dadb6b9b5255d5,1272,116,1630,1,3019,Thomas1bf1effec454d01e8804893fee773045295622ce4aab3dc304dadb6b9b5255d5
Tift,1bf1effec454d01e8804893fee773045295622ce4aab3dc304dadb6b9b5255d5,917,70,1172,1,2160,Tift1bf1effec454d01e8804893fee773045295622ce4aab3dc304dadb6b9b5255d5
Toombs,1bf1effec454d01e8804893fee773045295622ce4aab3dc304dadb6b9b5255d5,633,88,758,1,1480,Toombs1bf1effec454d01e8804893fee773045295622ce4aab3dc304dadb6b9b5255d5
Towns,1bf1effec454d01e8804893fee773045295622ce4aab3dc304dadb6b9b5255d5,328,56,706,1,1091,Towns1bf1effec454d01e8804893fee773045295622ce4aab3dc304dadb6b9b5255d5
Treutlen,1bf1effec454d01e8804893fee773045295622ce4aab3dc304dadb6b9b5255d5,184,18,284,1,487,Treutlen1bf1effec454d01e8804893fee773045295622ce4aab3dc304dadb6b9b5255d5
Troup,1bf1effec454d01e8804893fee773045295622ce4aab3dc304dadb6b9b5255d5,2188,176,2160,35,4559,Troup1bf1effec454d01e8804893fee773045295622ce4aab3dc304dadb6b9b5255d5
Turner,1bf1effec454d01e8804893fee773045295622ce4aab3dc304dadb6b9b5255d5,241,9,376,1,627,Turner1bf1effec454d01e8804893fee773045295622ce4aab3dc304dadb6b9b5255d5
Twiggs,1bf1effec454d01e8804893fee773045295622ce4aab3dc304dadb6b9b5255d5,427,82,314,0,823,Twiggs1bf1effec454d01e8804893fee773045295622ce4aab3dc304dadb6b9b5255d5
Union,1bf1effec454d01e8804893fee773045295622ce4aab3dc304dadb6b9b5255d5,757,89,1254,3,2103,Union1bf1effec454d01e8804893fee773045295622ce4aab3dc304dadb6b9b5255d5
Upson,1bf1effec454d01e8804893fee773045295622ce4aab3dc304dadb6b9b5255d5,544,52,1268,2,1866,Upson1bf1effec454d01e8804893fee773045295622ce4aab3dc304dadb6b9b5255d5
Walker,1bf1effec454d01e8804893fee773045295622ce4aab3dc304dadb6b9b5255d5,1312,126,1950,0,3388,Walker1bf1effec454d01e8804893fee773045295622ce4aab3dc304dadb6b9b5255d5
Walton,1bf1effec454d01e8804893fee773045295622ce4aab3dc304dadb6b9b5255d5,3254,204,2471,5,5934,Walton1bf1effec454d01e8804893fee773045295622ce4aab3dc304dadb6b9b5255d5
Ware,1bf1effec454d01e8804893fee773045295622ce4aab3dc304dadb6b9b5255d5,899,90,1126,2,2117,Ware1bf1effec454d01e8804893fee773045295622ce4aab3dc304dadb6b9b5255d5
Warren,1bf1effec454d01e8804893fee773045295622ce4aab3dc304dadb6b9b5255d5,239,15,266,0,520,Warren1bf1effec454d01e8804893fee773045295622ce4aab3dc304dadb6b9b5255d5
Washington,1bf1effec454d01e8804893fee773045295622ce4aab3dc304dadb6b9b5255d5,796,95,686,7,1584,Washington1bf1effec454d01e8804893fee773045295622ce4aab3dc304dadb6b9b5255d5
Wayne,1bf1effec454d01e8804893fee773045295622ce4aab3dc304dadb6b9b5255d5,736,81,974,3,1794,Wayne1bf1effec454d01e8804893fee773045295622ce4aab3dc304dadb6b9b5255d5
Webster,1bf1effec454d01e8804893fee773045295622ce4aab3dc304dadb6b9b5255d5,92,17,80,1,190,Webster1bf1effec454d01e8804893fee773045295622ce4aab3dc304dadb6b9b5255d5
Wheeler,1bf1effec454d01e8804893fee773045295622ce4aab3dc304dadb6b9b5255d5,171,16,188,0,375,Wheeler1bf1effec454d01e8804893fee773045295622ce4aab3dc304dadb6b9b5255d5
White,1bf1effec454d01e8804893fee773045295622ce4aab3dc304dadb6b9b5255d5,865,78,1059,2,2004,White1bf1effec454d01e8804893fee773045295622ce4aab3dc304dadb6b9b5255d5
Whitfield,1bf1effec454d01e8804893fee773045295622ce4aab3dc304dadb6b9b5255d5,2630,153,1997,5,4785,Whitfield1bf1effec454d01e8804893fee773045295622ce4aab3dc304dadb6b9b5255d5
Wilcox,1bf1effec454d01e8804893fee773045295622ce4aab3dc304dadb6b9b5255d5,317,30,190,0,537,Wilcox1bf1effec454d01e8804893fee773045295622ce4aab3dc304dadb6b9b5255d5
Wilkes,1bf1effec454d01e8804893fee773045295622ce4aab3dc304dadb6b9b5255d5,443,35,429,0,907,Wilkes1bf1effec454d01e8804893fee773045295622ce4aab3dc304dadb6b9b5255d5
Wilkinson,1bf1effec454d01e8804893fee773045295622ce4aab3dc304dadb6b9b5255d5,498,34,290,0,822,Wilkinson1bf1effec454d01e8804893fee773045295622ce4aab3dc304dadb6b9b5255d5
Worth,1bf1effec454d01e8804893fee773045295622ce4aab3dc304dadb6b9b5255d5,828,51,517,2,1398,Worth1bf1effec454d01e8804893fee773045295622ce4aab3dc304dadb6b9b5255d5
Appling,e018b2b28cf44efa764c48801c922205bfa7ea9492d292b5da84c28a27c100a0,1866,292,1510,2,3670,Applinge018b2b28cf44efa764c48801c922205bfa7ea9492d292b5da84c28a27c100a0
Atkinson,e018b2b28cf44efa764c48801c922205bfa7ea9492d292b5da84c28a27c100a0,643,48,623,0,1314,Atkinsone018b2b28cf44efa764c48801c922205bfa7ea9492d292b5da84c28a27c100a0
Bacon,e018b2b28cf44efa764c48801c922205bfa7ea9492d292b5da84c28a27c100a0,724,102,1246,3,2075,Bacone018b2b28cf44efa764c48801c922205bfa7ea9492d292b5da84c28a27c100a0
Baker,e018b2b28cf44efa764c48801c922205bfa7ea9492d292b5da84c28a27c100a0,345,76,264,1,686,Bakere018b2b28cf44efa764c48801c922205bfa7ea9492d292b5da84c28a27c100a0
Baldwin,e018b2b28cf44efa764c48801c922205bfa7ea9492d292b5da84c28a27c100a0,3215,469,4481,4,8169,Baldwine018b2b28cf44efa764c48801c922205bfa7ea9492d292b5da84c28a27c100a0
Banks,e018b2b28cf44efa764c48801c922205bfa7ea9492d292b5da84c28a27c100a0,1949,147,1716,1,3813,Bankse018b2b28cf44efa764c48801c922205bfa7ea9492d292b5da84c28a27c100a0
Barrow,e018b2b28cf44efa764c48801c922205bfa7ea9492d292b5da84c28a27c100a0,7445,753,9512,0,17710,Barrowe018b2b28cf44efa764c48801c922205bfa7ea9492d292b5da84c28a27c100a0
Bartow,e018b2b28cf44efa764c48801c922205bfa7ea9492d292b5da84c28a27c100a0,11806,908,10141,17,22872,Bartowe018b2b28cf44efa764c48801c922205bfa7ea9492d292b5da84c28a27c100a0
Ben Hill,e018b2b28cf44efa764c48801c922205bfa7ea9492d292b5da84c28a27c100a0,892,149,2090,5,3136,Ben Hille018b2b28cf44efa764c48801c922205bfa7ea9492d292b5da84c28a27c100a0
Berrien,e018b2b28cf44efa764c48801c922205bfa7ea9492d292b5da84c28a27c100a0,1641,226,1815,15,3697,Berriene018b2b28cf44efa764c48801c922205bfa7ea9492d292b5da84c28a27c100a0
Bibb,e018b2b28cf44efa764c48801c922205bfa7ea9492d292b5da84c28a27c100a0,16329,2076,15700,120,34225,Bibbe018b2b28cf44efa764c48801c922205bfa7ea9492d292b5da84c28a27c100a0
Bleckley,e018b2b28cf44efa764c48801c922205bfa7ea9492d292b5da84c28a27c100a0,1117,120,1495,2,2734,Bleckleye018b2b28cf44efa764c48801c922205bfa7ea9492d292b5da84c28a27c100a0
Brantley,e018b2b28cf44efa764c48801c922205bfa7ea9492d292b5da84c28a27c100a0,1496,131,1598,4,3229,Brantleye018b2b28cf44efa764c48801c922205bfa7ea9492d292b5da84c28a27c100a0
Brooks,e018b2b28cf44efa764c48801c922205bfa7ea9492d292b5da84c28a27c100a0,1559,354,1617,29,3559,Brookse018b2b28cf44efa764c48801c922205bfa7ea9492d292b5da84c28a27c100a0
Bryan,e018b2b28cf44efa764c48801c922205bfa7ea9492d292b5da84c28a27c100a0,3492,330,5631,7,9460,Bryane018b2b28cf44efa764c48801c922205bfa7ea9492d292b5da84c28a27c100a0
Bulloch,e018b2b28cf44efa764c48801c922205bfa7ea9492d292b5da84c28a27c100a0,6646,616,7076,36,14374,Bulloche018b2b28cf44efa764c48801c922205bfa7ea9492d292b5da84c28a27c100a0
Burke,e018b2b28cf44efa764c48801c922205bfa7ea9492d292b5da84c28a27c100a0,2616,450,1933,0,4999,Burkee018b2b28cf44efa764c48801c922205bfa7ea9492d292b5da84c28a27c100a0
Butts,e018b2b28cf44efa764c48801c922205bfa7ea9492d292b5da84c28a27c100a0,1590,166,3850,0,5606,Buttse018b2b28cf44efa764c48801c922205bfa7ea9492d292b5da84c28a27c100a0
Calhoun,e018b2b28cf44efa764c48801c922205bfa7ea9492d292b5da84c28a27c100a0,574,87,349,1,1011,Calhoune018b2b28cf44efa764c48801c922205bfa7ea9492d292b5da84c28a27c100a0
Camden,e018b2b28cf44efa764c48801c922205bfa7ea9492d292b5da84c28a27c100a0,4513,715,6229,12,11469,Camdene018b2b28cf44efa764c48801c922205bfa7ea9492d292b5da84c28a27c100a0
Candler,e018b2b28cf44efa764c48801c922205bfa7ea9492d292b5da84c28a27c100a0,595,74,1404,2,2075,Candlere018b2b28cf44efa764c48801c922205bfa7ea9492d292b5da84c28a27c100a0
Carroll,e018b2b28cf44efa764c48801c922205bfa7ea9492d292b5da84c28a27c100a0,10630,894,13649,57,25230,Carrolle018b2b28cf44efa764c48801c922205bfa7ea9492d292b5da84c28a27c100a0
Catoosa,e018b2b28cf44efa764c48801c922205bfa7ea9492d292b5da84c28a27c100a0,5494,436,10130,9,16069,Catoosae018b2b28cf44efa764c48801c922205bfa7ea9492d292b5da84c28a27c100a0
Charlton,e018b2b28cf44efa764c48801c922205bfa7ea9492d292b5da84c28a27c100a0,857,109,1125,3,2094,Charltone018b2b28cf44efa764c48801c922205bfa7ea9492d292b5da84c28a27c100a0
Chatham,e018b2b28cf44efa764c48801c922205bfa7ea9492d292b5da84c28a27c100a0,38188,2822,19584,64,60658,Chathame018b2b28cf44efa764c48801c922205bfa7ea9492d292b5da84c28a27c100a0
Chattahoochee,e018b2b28cf44efa764c48801c922205bfa7ea9492d292b5da84c28a27c100a0,411,37,356,4,808,Chattahoocheee018b2b28cf44efa764c48801c922205bfa7ea9492d292b5da84c28a27c100a0
Chattooga,e018b2b28cf44efa764c48801c922205bfa7ea9492d292b5da84c28a27c100a0,2130,141,2451,2,4724,Chattoogae018b2b28cf44efa764c48801c922205bfa7ea9492d292b5da84c28a27c100a0
Cherokee,e018b2b28cf44efa764c48801c922205bfa7ea9492d292b5da84c28a27c100a0,25700,3198,35550,18,64466,Cherokeee018b2b28cf44efa764c48801c922205bfa7ea9492d292b5da84c28a27c100a0
Clarke,e018b2b28cf44efa764c48801c922205bfa7ea9492d292b5da84c28a27c100a0,8697,1256,9640,31,19624,Clarkee018b2b28cf44efa764c48801c922205bfa7ea9492d292b5da84c28a27c100a0
Clay,e018b2b28cf44efa764c48801c922205bfa7ea9492d292b5da84c28a27c100a0,310,70,337,1,718,Claye018b2b28cf44efa764c48801c922205bfa7ea9492d292b5da84c28a27c100a0
Clayton,e018b2b28cf44efa764c48801c922205bfa7ea9492d292b5da84c28a27c100a0,22172,1999,36057,95,60323,Claytone018b2b28cf44efa764c48801c922205bfa7ea9492d292b5da84c28a27c100a0
Clinch,e018b2b28cf44efa764c48801c922205bfa7ea9492d292b5da84c28a27c100a0,536,37,652,2,1227,Clinche018b2b28cf44efa764c48801c922205bfa7ea9492d292b5da84c28a27c100a0
Cobb,e018b2b28cf44efa764c48801c922205bfa7ea9492d292b5da84c28a27c100a0,92416,13533,81594,444,187987,Cobbe018b2b28cf44efa764c48801c922205bfa7ea9492d292b5da84c28a27c100a0
Coffee,e018b2b28cf44efa764c48801c922205bfa7ea9492d292b5da84c28a27c100a0,2492,285,4657,0,7434,Coffeee018b2b28cf44efa764c48801c922205bfa7ea9492d292b5da84c28a27c100a0
Colquitt,e018b2b28cf44efa764c48801c922205bfa7ea9492d292b5da84c28a27c100a0,3548,292,3346,3,7189,Colquitte018b2b28cf44efa764c48801c922205bfa7ea9492d292b5da84c28a27c100a0
Columbia,e018b2b28cf44efa764c48801c922205bfa7ea9492d292b5da84c28a27c100a0,16172,2043,23206,23,41444,Columbiae018b2b28cf44efa764c48801c922205bfa7ea9492d292b5da84c28a27c100a0
Cook,e018b2b28cf44efa764c48801c922205bfa7ea9492d292b5da84c28a27c100a0,1418,147,1864,0,3429,Cooke018b2b28cf44efa764c48801c922205bfa7ea9492d292b5da84c28a27c100a0
Coweta,e018b2b28cf44efa764c48801c922205bfa7ea9492d292b5da84c28a27c100a0,15645,1795,18220,16,35676,Cowetae018b2b28cf44efa764c48801c922205bfa7ea9492d292b5da84c28a27c100a0
Crawford,e018b2b28cf44efa764c48801c922205bfa7ea9492d292b5da84c28a27c100a0,1248,156,1372,3,2779,Crawforde018b2b28cf44efa764c48801c922205bfa7ea9492d292b5da84c28a27c100a0
Crisp,e018b2b28cf44efa764c48801c922205bfa7ea9492d292b5da84c28a27c100a0,1401,206,2733,8,4348,Crispe018b2b28cf44efa764c48801c922205bfa7ea9492d292b5da84c28a27c100a0
Dade,e018b2b28cf44efa764c48801c922205bfa7ea9492d292b5da84c28a27c100a0,1831,97,1702,0,3630,Dadee018b2b28cf44efa764c48801c922205bfa7ea9492d292b5da84c28a27c100a0
Dawson,e018b2b28cf44efa764c48801c922205bfa7ea9492d292b5da84c28a27c100a0,1799,297,4779,13,6888,Dawsone018b2b28cf44efa764c48801c922205bfa7ea9492d292b5da84c28a27c100a0
Decatur,e018b2b28cf44efa764c48801c922205bfa7ea9492d292b5da84c28a27c100a0,2196,305,2975,16,5492,Decature018b2b28cf44efa764c48801c922205bfa7ea9492d292b5da84c28a27c100a0
DeKalb,e018b2b28cf44efa764c48801c922205bfa7ea9492d292b5da84c28a27c100a0,64939,8321,97758,275,171293,DeKalbe018b2b28cf44efa764c48801c922205bfa7ea9492d292b5da84c28a27c100a0
Dodge,e018b2b28cf44efa764c48801c922205bfa7ea9492d292b5da84c28a27c100a0,1828,191,1497,0,3516,Dodgee018b2b28cf44efa764c48801c922205bfa7ea9492d292b5da84c28a27c100a0
Dooly,e018b2b28cf44efa764c48801c922205bfa7ea9492d292b5da84c28a27c100a0,1006,109,995,12,2122,Doolye018b2b28cf44efa764c48801c922205bfa7ea9492d292b5da84c28a27c100a0
Dougherty,e018b2b28cf44efa764c48801c922205bfa7ea9492d292b5da84c28a27c100a0,10282,934,8367,53,19636,Doughertye018b2b28cf44efa764c48801c922205bfa7ea9492d292b5da84c28a27c100a0
Douglas,e018b2b28cf44efa764c48801c922205bfa7ea9492d292b5da84c28a27c100a0,11613,1505,21475,19,34612,Douglase018b2b28cf44efa764c48801c922205bfa7ea9492d292b5da84c28a27c100a0
Early,e018b2b28cf44efa764c48801c922205bfa7ea9492d292b5da84c28a27c100a0,1156,237,1126,0,2519,Earlye018b2b28cf44efa764c48801c922205bfa7ea9492d292b5da84c28a27c100a0
Echols,e018b2b28cf44efa764c48801c922205bfa7ea9492d292b5da84c28a27c100a0,265,22,352,0,639,Echolse018b2b28cf44efa764c48801c922205bfa7ea9492d292b5da84c28a27c100a0
Effingham,e018b2b28cf44efa764c48801c922205bfa7ea9492d292b5da84c28a27c100a0,6552,427,7422,6,14407,Effinghame018b2b28cf44efa764c48801c922205bfa7ea9492d292b5da84c28a27c100a0
Elbert,e018b2b28cf44efa764c48801c922205bfa7ea9492d292b5da84c28a27c100a0,1523,276,2370,41,4210,Elberte018b2b28cf44efa764c48801c922205bfa7ea9492d292b5da84c28a27c100a0
Emanuel,e018b2b28cf44efa764c48801c922205bfa7ea9492d292b5da84c28a27c100a0,2277,183,1808,4,4272,Emanuele018b2b28cf44efa764c48801c922205bfa7ea9492d292b5da84c28a27c100a0
Evans,e018b2b28cf44efa764c48801c922205bfa7ea9492d292b5da84c28a27c100a0,621,90,1210,0,1921,Evanse018b2b28cf44efa764c48801c922205bfa7ea9492d292b5da84c28a27c100a0
Fannin,e018b2b28cf44efa764c48801c922205bfa7ea9492d292b5da84c28a27c100a0,2570,473,3319,3,6365,Fannine018b2b28cf44efa764c48801c922205bfa7ea9492d292b5da84c28a27c100a0
Fayette,e018b2b28cf44efa764c48801c922205bfa7ea9492d292b5da84c28a27c100a0,10159,1643,21669,18,33489,Fayettee018b2b28cf44efa764c48801c922205bfa7ea9492d292b5da84c28a27c100a0
Floyd,e018b2b28cf44efa764c48801c922205bfa7ea9492d292b5da84c28a27c100a0,7893,801,10499,68,19261,Floyde018b2b28cf44efa764c48801c922205bfa7ea9492d292b5da84c28a27c100a0
Forsyth,e018b2b28cf44efa764c48801c922205bfa7ea9492d292b5da84c28a27c100a0,15447,2454,41318,21,59240,Forsythe018b2b28cf44efa764c48801c922205bfa7ea9492d292b5da84c28a27c100a0
Franklin,e018b2b28cf44efa764c48801c922205bfa7ea9492d292b5da84c28a27c100a0,2391,245,2271,0,4907,Frankline018b2b28cf44efa764c48801c922205bfa7ea9492d292b5da84c28a27c100a0
Fulton,e018b2b28cf44efa764c48801c922205bfa7ea9492d292b5da84c28a27c100a0,85414,11545,146035,634,243628,Fultone018b2b28cf44efa764c48801c922205bfa7ea9492d292b5da84c28a27c100a0
Gilmer,e018b2b28cf44efa764c48801c922205bfa7ea9492d292b5da84c28a27c100a0,2668,418,3737,6,6829,Gilmere018b2b28cf44efa764c48801c922205bfa7ea9492d292b5da84c28a27c100a0
Glascock,e018b2b28cf44efa764c48801c922205bfa7ea9492d292b5da84c28a27c100a0,320,26,351,0,697,Glascocke018b2b28cf44efa764c48801c922205bfa7ea9492d292b5da84c28a27c100a0
Glynn,e018b2b28cf44efa764c48801c922205bfa7ea9492d292b5da84c28a27c100a0,7747,971,10080,28,18826,Glynne018b2b28cf44efa764c48801c922205bfa7ea9492d292b5da84c28a27c100a0
Gordon,e018b2b28cf44efa764c48801c922205bfa7ea9492d292b5da84c28a27c100a0,4826,347,5240,13,10426,Gordone018b2b28cf44efa764c48801c922205bfa7ea9492d292b5da84c28a27c100a0
Grady,e018b2b28cf44efa764c48801c922205bfa7ea9492d292b5da84c28a27c100a0,2075,155,2813,5,5048,Gradye018b2b28cf44efa764c48801c922205bfa7ea9492d292b5da84c28a27c100a0
Greene,e018b2b28cf44efa764c48801c922205bfa7ea9492d292b5da84c28a27c100a0,1461,326,3294,3,5084,Greenee018b2b28cf44efa764c48801c922205bfa7ea9492d292b5da84c28a27c100a0
Gwinnett,e018b2b28cf44efa764c48801c922205bfa7ea9492d292b5da84c28a27c100a0,94734,11104,91213,911,197962,Gwinnette018b2b28cf44efa764c48801c922205bfa7ea9492d292b5da84c28a27c100a0
Habersham,e018b2b28cf44efa764c48801c922205bfa7ea9492d292b5da84c28a27c100a0,2011,601,6813,2,9427,Habershame018b2b28cf44efa764c48801c922205bfa7ea9492d292b5da84c28a27c100a0
Hall,e018b2b28cf44efa764c48801c922205bfa7ea9492d292b5da84c28a27c100a0,18490,2116,20288,34,40928,Halle018b2b28cf44efa764c48801c922205bfa7ea9492d292b5da84c28a27c100a0
Hancock,e018b2b28cf44efa764c48801c922205bfa7ea9492d292b5da84c28a27c100a0,809,147,678,5,1639,Hancocke018b2b28cf44efa764c48801c922205bfa7ea9492d292b5da84c28a27c100a0
Haralson,e018b2b28cf44efa764c48801c922205bfa7ea9492d292b5da84c28a27c100a0,3091,283,2859,6,6239,Haralsone018b2b28cf44efa764c48801c922205bfa7ea9492d292b5da84c28a27c100a0
Harris,e018b2b28cf44efa764c48801c922205bfa7ea9492d292b5da84c28a27c100a0,4108,443,5168,0,9719,Harrise018b2b28cf44efa764c48801c922205bfa7ea9492d292b5da84c28a27c100a0
Hart,e018b2b28cf44efa764c48801c922205bfa7ea9492d292b5da84c28a27c100a0,2190,279,2752,0,5221,Harte018b2b28cf44efa764c48801c922205bfa7ea9492d292b5da84c28a27c100a0
Heard,e018b2b28cf44efa764c48801c922205bfa7ea9492d292b5da84c28a27c100a0,1277,171,999,2,2449,Hearde018b2b28cf44efa764c48801c922205bfa7ea9492d292b5da84c28a27c100a0
Henry,e018b2b28cf44efa764c48801c922205bfa7ea9492d292b5da84c28a27c100a0,16107,2189,40808,109,59213,Henrye018b2b28cf44efa764c48801c922205bfa7ea9492d292b5da84c28a27c100a0
Houston,e018b2b28cf44efa764c48801c922205bfa7ea9492d292b5da84c28a27c100a0,11291,1570,22492,81,35434,Houstone018b2b28cf44efa764c48801c922205bfa7ea9492d292b5da84c28a27c100a0
Irwin,e018b2b28cf44efa764c48801c922205bfa7ea9492d292b5da84c28a27c100a0,796,68,926,2,1792,Irwine018b2b28cf44efa764c48801c922205bfa7ea9492d292b5da84c28a27c100a0
Jackson,e018b2b28cf44efa764c48801c922205bfa7ea9492d292b5da84c28a27c100a0,5589,476,9603,28,15696,Jacksone018b2b28cf44efa764c48801c922205bfa7ea9492d292b5da84c28a27c100a0
Jasper,e018b2b28cf44efa764c48801c922205bfa7ea9492d292b5da84c28a27c100a0,1309,205,1772,2,3288,Jaspere018b2b28cf44efa764c48801c922205bfa7ea9492d292b5da84c28a27c100a0
Jeff Davis,e018b2b28cf44efa764c48801c922205bfa7ea9492d292b5da84c28a27c100a0,1144,100,1312,2,2558,Jeff Davise018b2b28cf44efa764c48801c922205bfa7ea9492d292b5da84c28a27c100a0
Jefferson,e018b2b28cf44efa764c48801c922205bfa7ea9492d292b5da84c28a27c100a0,1645,247,1318,7,3217,Jeffersone018b2b28cf44efa764c48801c922205bfa7ea9492d292b5da84c28a27c100a0
Jenkins,e018b2b28cf44efa764c48801c922205bfa7ea9492d292b5da84c28a27c100a0,699,94,813,10,1616,Jenkinse018b2b28cf44efa764c48801c922205bfa7ea9492d292b5da84c28a27c100a0
Johnson,e018b2b28cf44efa764c48801c922205bfa7ea9492d292b5da84c28a27c100a0,694,111,849,0,1654,Johnsone018b2b28cf44efa764c48801c922205bfa7ea9492d292b5da84c28a27c100a0
Jones,e018b2b28cf44efa764c48801c922205bfa7ea9492d292b5da84c28a27c100a0,2530,454,3860,1,6845,Jonese018b2b28cf44efa764c48801c922205bfa7ea9492d292b5da84c28a27c100a0
Lamar,e018b2b28cf44efa764c48801c922205bfa7ea9492d292b5da84c28a27c100a0,1594,192,2357,8,4151,Lamare018b2b28cf44efa764c48801c922205bfa7ea9492d292b5da84c28a27c100a0
Lanier,e018b2b28cf44efa764c48801c922205bfa7ea9492d292b5da84c28a27c100a0,667,47,938,0,1652,Laniere018b2b28cf44efa764c48801c922205bfa7ea9492d292b5da84c28a27c100a0
Laurens,e018b2b28cf44efa764c48801c922205bfa7ea9492d292b5da84c28a27c100a0,5012,637,4351,0,10000,Laurense018b2b28cf44efa764c48801c922205bfa7ea9492d292b5da84c28a27c100a0
Lee,e018b2b28cf44efa764c48801c922205bfa7ea9492d292b5da84c28a27c100a0,3912,316,4319,3,8550,Leee018b2b28cf44efa764c48801c922205bfa7ea9492d292b5da84c28a27c100a0
Liberty,e018b2b28cf44efa764c48801c922205bfa7ea9492d292b5da84c28a27c100a0,4059,345,5762,19,10185,Libertye018b2b28cf44efa764c48801c922205bfa7ea9492d292b5da84c28a27c100a0
Lincoln,e018b2b28cf44efa764c48801c922205bfa7ea9492d292b5da84c28a27c100a0,894,184,1135,0,2213,Lincolne018b2b28cf44efa764c48801c922205bfa7ea9492d292b5da84c28a27c100a0
Long,e018b2b28cf44efa764c48801c922205bfa7ea9492d292b5da84c28a27c100a0,1247,58,1218,4,2527,Longe018b2b28cf44efa764c48801c922205bfa7ea9492d292b5da84c28a27c100a0
Lowndes,e018b2b28cf44efa764c48801c922205bfa7ea9492d292b5da84c28a27c100a0,6613,935,14003,311,21862,Lowndese018b2b28cf44efa764c48801c922205bfa7ea9492d292b5da84c28a27c100a0
Lumpkin,e018b2b28cf44efa764c48801c922205bfa7ea9492d292b5da84c28a27c100a0,1638,320,4934,5,6897,Lumpkine018b2b28cf44efa764c48801c922205bfa7ea9492d292b5da84c28a27c100a0
Macon,e018b2b28cf44efa764c48801c922205bfa7ea9492d292b5da84c28a27c100a0,1037,139,1131,0,2307,Macone018b2b28cf44efa764c48801c922205bfa7ea9492d292b5da84c28a27c100a0
Madison,e018b2b28cf44efa764c48801c922205bfa7ea9492d292b5da84c28a27c100a0,2666,262,3198,5,6131,Madisone018b2b28cf44efa764c48801c922205bfa7ea9492d292b5da84c28a27c100a0
Marion,e018b2b28cf44efa764c48801c922205bfa7ea9492d292b5da84c28a27c100a0,841,124,710,0,1675,Marione018b2b28cf44efa764c48801c922205bfa7ea9492d292b5da84c28a27c100a0
McDuffie,e018b2b28cf44efa764c48801c922205bfa7ea9492d292b5da84c28a27c100a0,2045,334,3044,0,5423,McDuffiee018b2b28cf44efa764c48801c922205bfa7ea9492d292b5da84c28a27c100a0
McIntosh,e018b2b28cf44efa764c48801c922205bfa7ea9492d292b5da84c28a27c100a0,1183,327,1641,8,3159,McIntoshe018b2b28cf44efa764c48801c922205bfa7ea9492d292b5da84c28a27c100a0
Meriwether,e018b2b28cf44efa764c48801c922205bfa7ea9492d292b5da84c28a27c100a0,2985,257,1957,4,5203,Meriwethere018b2b28cf44efa764c48801c922205bfa7ea9492d292b5da84c28a27c100a0
Miller,e018b2b28cf44efa764c48801c922205bfa7ea9492d292b5da84c28a27c100a0,556,90,566,2,1214,Millere018b2b28cf44efa764c48801c922205bfa7ea9492d292b5da84c28a27c100a0
Mitchell,e018b2b28cf44efa764c48801c922205bfa7ea9492d292b5da84c28a27c100a0,1948,309,2157,5,4419,Mitchelle018b2b28cf44efa764c48801c922205bfa7ea9492d292b5da84c28a27c100a0
Monroe,e018b2b28cf44efa764c48801c922205bfa7ea9492d292b5da84c28a27c100a0,3006,301,3540,6,6853,Monroee018b2b28cf44efa764c48801c922205bfa7ea9492d292b5da84c28a27c100a0
Montgomery,e018b2b28cf44efa764c48801c922205bfa7ea9492d292b5da84c28a27c100a0,1056,65,687,0,1808,Montgomerye018b2b28cf44efa764c48801c922205bfa7ea9492d292b5da84c28a27c100a0
Morgan,e018b2b28cf44efa764c48801c922205bfa7ea9492d292b5da84c28a27c100a0,1853,212,2973,2,5040,Morgane018b2b28cf44efa764c48801c922205bfa7ea9492d292b5da84c28a27c100a0
Murray,e018b2b28cf44efa764c48801c922205bfa7ea9492d292b5da84c28a27c100a0,3537,230,3102,0,6869,Murraye018b2b28cf44efa764c48801c922205bfa7ea9492d292b5da84c28a27c100a0
Muscogee,e018b2b28cf44efa764c48801c922205bfa7ea9492d292b5da84c28a27c100a0,18385,2194,19442,77,40098,Muscogeee018b2b28cf44efa764c48801c922205bfa7ea9492d292b5da84c28a27c100a0
Newton,e018b2b28cf44efa764c48801c922205bfa7ea9492d292b5da84c28a27c100a0,11666,1196,12470,4,25336,Newtone018b2b28cf44efa764c48801c922205bfa7ea9492d292b5da84c28a27c100a0
Oconee,e018b2b28cf44efa764c48801c922205bfa7ea9492d292b5da84c28a27c100a0,3633,462,5730,3,9828,Oconeee018b2b28cf44efa764c48801c922205bfa7ea9492d292b5da84c28a27c100a0
Oglethorpe,e018b2b28cf44efa764c48801c922205bfa7ea9492d292b5da84c28a27c100a0,1127,213,2000,2,3342,Oglethorpee018b2b28cf44efa764c48801c922205bfa7ea9492d292b5da84c28a27c100a0
Paulding,e018b2b28cf44efa764c48801c922205bfa7ea9492d292b5da84c28a27c100a0,11470,1928,25782,18,39198,Pauldinge018b2b28cf44efa764c48801c922205bfa7ea9492d292b5da84c28a27c100a0
Peach,e018b2b28cf44efa764c48801c922205bfa7ea9492d292b5da84c28a27c100a0,1917,212,4012,12,6153,Peache018b2b28cf44efa764c48801c922205bfa7ea9492d292b5da84c28a27c100a0
Pickens,e018b2b28cf44efa764c48801c922205bfa7ea9492d292b5da84c28a27c100a0,3033,162,4630,1,7826,Pickense018b2b28cf44efa764c48801c922205bfa7ea9492d292b5da84c28a27c100a0
Pierce,e018b2b28cf44efa764c48801c922205bfa7ea9492d292b5da84c28a27c100a0,1082,191,2541,1,3815,Piercee018b2b28cf44efa764c48801c922205bfa7ea9492d292b5da84c28a27c100a0
Pike,e018b2b28cf44efa764c48801c922205bfa7ea9492d292b5da84c28a27c100a0,1704,220,2628,4,4556,Pikee018b2b28cf44efa764c48801c922205bfa7ea9492d292b5da84c28a27c100a0
Polk,e018b2b28cf44efa764c48801c922205bfa7ea9492d292b5da84c28a27c100a0,2524,285,5211,4,8024,Polke018b2b28cf44efa764c48801c922205bfa7ea9492d292b5da84c28a27c100a0
Pulaski,e018b2b28cf44efa764c48801c922205bfa7ea9492d292b5da84c28a27c100a0,503,106,1330,1,1940,Pulaskie018b2b28cf44efa764c48801c922205bfa7ea9492d292b5da84c28a27c100a0
Putnam,e018b2b28cf44efa764c48801c922205bfa7ea9492d292b5da84c28a27c100a0,2002,350,2945,3,5300,Putname018b2b28cf44efa764c48801c922205bfa7ea9492d292b5da84c28a27c100a0
Quitman,e018b2b28cf44efa764c48801c922205bfa7ea9492d292b5da84c28a27c100a0,250,35,277,0,562,Quitmane018b2b28cf44efa764c48801c922205bfa7ea9492d292b5da84c28a27c100a0
Rabun,e018b2b28cf44efa764c48801c922205bfa7ea9492d292b5da84c28a27c100a0,795,562,3131,0,4488,Rabune018b2b28cf44efa764c48801c922205bfa7ea9492d292b5da84c28a27c100a0
Randolph,e018b2b28cf44efa764c48801c922205bfa7ea9492d292b5da84c28a27c100a0,805,99,720,1,1625,Randolphe018b2b28cf44efa764c48801c922205bfa7ea9492d292b5da84c28a27c100a0
Richmond,e018b2b28cf44efa764c48801c922205bfa7ea9492d292b5da84c28a27c100a0,20946,2708,21609,73,45336,Richmonde018b2b28cf44efa764c48801c922205bfa7ea9492d292b5da84c28a27c100a0
Rockdale,e018b2b28cf44efa764c48801c922205bfa7ea9492d292b5da84c28a27c100a0,6186,890,15027,15,22118,Rockdalee018b2b28cf44efa764c48801c922205bfa7ea9492d292b5da84c28a27c100a0
Schley,e018b2b28cf44efa764c48801c922205bfa7ea9492d292b5da84c28a27c100a0,320,42,623,0,985,Schleye018b2b28cf44efa764c48801c922205bfa7ea9492d292b5da84c28a27c100a0
Screven,e018b2b28cf44efa764c48801c922205bfa7ea9492d292b5da84c28a27c100a0,1534,99,1439,0,3072,Screvene018b2b28cf44efa764c48801c922205bfa7ea9492d292b5da84c28a27c100a0
Seminole,e018b2b28cf44efa764c48801c922205bfa7ea9492d292b5da84c28a27c100a0,1125,98,825,2,2050,Seminolee018b2b28cf44efa764c48801c922205bfa7ea9492d292b5da84c28a27c100a0
Spalding,e018b2b28cf44efa764c48801c922205bfa7ea9492d292b5da84c28a27c100a0,5318,602,7829,10,13759,Spaldinge018b2b28cf44efa764c48801c922205bfa7ea9492d292b5da84c28a27c100a0
Stephens,e018b2b28cf44efa764c48801c922205bfa7ea9492d292b5da84c28a27c100a0,1217,386,4016,3,5622,Stephense018b2b28cf44efa764c48801c922205bfa7ea9492d292b5da84c28a27c100a0
Stewart,e018b2b28cf44efa764c48801c922205bfa7ea9492d292b5da84c28a27c100a0,450,173,366,2,991,Stewarte018b2b28cf44efa764c48801c922205bfa7ea9492d292b5da84c28a27c100a0
Sumter,e018b2b28cf44efa764c48801c922205bfa7ea9492d292b5da84c28a27c100a0,2312,396,3040,0,5748,Sumtere018b2b28cf44efa764c48801c922205bfa7ea9492d292b5da84c28a27c100a0
Talbot,e018b2b28cf44efa764c48801c922205bfa7ea9492d292b5da84c28a27c100a0,991,310,456,0,1757,Talbote018b2b28cf44efa764c48801c922205bfa7ea9492d292b5da84c28a27c100a0
Taliaferro,e018b2b28cf44efa764c48801c922205bfa7ea9492d292b5da84c28a27c100a0,183,50,184,0,417,Taliaferroe018b2b28cf44efa764c48801c922205bfa7ea9492d292b5da84c28a27c100a0
Tattnall,e018b2b28cf44efa764c48801c922205bfa7ea9492d292b5da84c28a27c100a0,1358,282,1854,3,3497,Tattnalle018b2b28cf44efa764c48801c922205bfa7ea9492d292b5da84c28a27c100a0
Taylor,e018b2b28cf44efa764c48801c922205bfa7ea9492d292b5da84c28a27c100a0,750,175,897,0,1822,Taylore018b2b28cf44efa764c48801c922205bfa7ea9492d292b5da84c28a27c100a0
Telfair,e018b2b28cf44efa764c48801c922205bfa7ea9492d292b5da84c28a27c100a0,979,131,659,0,1769,Telfaire018b2b28cf44efa764c48801c922205bfa7ea9492d292b5da84c28a27c100a0
Terrell,e018b2b28cf44efa764c48801c922205bfa7ea9492d292b5da84c28a27c100a0,1122,137,1077,2,2338,Terrelle018b2b28cf44efa764c48801c922205bfa7ea9492d292b5da84c28a27c100a0
Thomas,e018b2b28cf44efa764c48801c922205bfa7ea9492d292b5da84c28a27c100a0,4052,473,5972,4,10501,Thomase018b2b28cf44efa764c48801c922205bfa7ea9492d292b5da84c28a27c100a0
Tift,e018b2b28cf44efa764c48801c922205bfa7ea9492d292b5da84c28a27c100a0,3033,323,4588,10,7954,Tifte018b2b28cf44efa764c48801c922205bfa7ea9492d292b5da84c28a27c100a0
Toombs,e018b2b28cf44efa764c48801c922205bfa7ea9492d292b5da84c28a27c100a0,1993,345,2588,1,4927,Toombse018b2b28cf44efa764c48801c922205bfa7ea9492d292b5da84c28a27c100a0
Towns,e018b2b28cf44efa764c48801c922205bfa7ea9492d292b5da84c28a27c100a0,971,244,2467,5,3687,Townse018b2b28cf44efa764c48801c922205bfa7ea9492d292b5da84c28a27c100a0
Treutlen,e018b2b28cf44efa764c48801c922205bfa7ea9492d292b5da84c28a27c100a0,474,101,785,2,1362,Treutlene018b2b28cf44efa764c48801c922205bfa7ea9492d292b5da84c28a27c100a0
Troup,e018b2b28cf44efa764c48801c922205bfa7ea9492d292b5da84c28a27c100a0,6875,725,7216,141,14957,Troupe018b2b28cf44efa764c48801c922205bfa7ea9492d292b5da84c28a27c100a0
Turner,e018b2b28cf44efa764c48801c922205bfa7ea9492d292b5da84c28a27c100a0,643,44,1127,3,1817,Turnere018b2b28cf44efa764c48801c922205bfa7ea9492d292b5da84c28a27c100a0
Twiggs,e018b2b28cf44efa764c48801c922205bfa7ea9492d292b5da84c28a27c100a0,1046,169,790,1,2006,Twiggse018b2b28cf44efa764c48801c922205bfa7ea9492d292b5da84c28a27c100a0
Union,e018b2b28cf44efa764c48801c922205bfa7ea9492d292b5da84c28a27c100a0,1968,387,3998,1,6354,Unione018b2b28cf44efa764c48801c922205bfa7ea9492d292b5da84c28a27c100a0
Upson,e018b2b28cf44efa764c48801c922205bfa7ea9492d292b5da84c28a27c100a0,1681,268,3842,2,5793,Upsone018b2b28cf44efa764c48801c922205bfa7ea9492d292b5da84c28a27c100a0
Walker,e018b2b28cf44efa764c48801c922205bfa7ea9492d292b5da84c28a27c100a0,5842,604,7927,8,14381,Walkere018b2b28cf44efa764c48801c922205bfa7ea9492d292b5da84c28a27c100a0
Walton,e018b2b28cf44efa764c48801c922205bfa7ea9492d292b5da84c28a27c100a0,11992,1046,10749,23,23810,Waltone018b2b28cf44efa764c48801c922205bfa7ea9492d292b5da84c28a27c100a0
Ware,e018b2b28cf44efa764c48801c922205bfa7ea9492d292b5da84c28a27c100a0,2649,351,3911,2,6913,Waree018b2b28cf44efa764c48801c922205bfa7ea9492d292b5da84c28a27c100a0
Warren,e018b2b28cf44efa764c48801c922205bfa7ea9492d292b5da84c28a27c100a0,517,78,584,1,1180,Warrene018b2b28cf44efa764c48801c922205bfa7ea9492d292b5da84c28a27c100a0
Washington,e018b2b28cf44efa764c48801c922205bfa7ea9492d292b5da84c28a27c100a0,1699,368,1906,13,3986,Washingtone018b2b28cf44efa764c48801c922205bfa7ea9492d292b5da84c28a27c100a0
Wayne,e018b2b28cf44efa764c48801c922205bfa7ea9492d292b5da84c28a27c100a0,2373,230,3036,6,5645,Waynee018b2b28cf44efa764c48801c922205bfa7ea9492d292b5da84c28a27c100a0
Webster,e018b2b28cf44efa764c48801c922205bfa7ea9492d292b5da84c28a27c100a0,261,66,244,0,571,Webstere018b2b28cf44efa764c48801c922205bfa7ea9492d292b5da84c28a27c100a0
Wheeler,e018b2b28cf44efa764c48801c922205bfa7ea9492d292b5da84c28a27c100a0,467,65,472,2,1006,Wheelere018b2b28cf44efa764c48801c922205bfa7ea9492d292b5da84c28a27c100a0
White,e018b2b28cf44efa764c48801c922205bfa7ea9492d292b5da84c28a27c100a0,2686,376,3486,9,6557,Whitee018b2b28cf44efa764c48801c922205bfa7ea9492d292b5da84c28a27c100a0
Whitfield,e018b2b28cf44efa764c48801c922205bfa7ea9492d292b5da84c28a27c100a0,8534,660,7170,17,16381,Whitfielde018b2b28cf44efa764c48801c922205bfa7ea9492d292b5da84c28a27c100a0
Wilcox,e018b2b28cf44efa764c48801c922205bfa7ea9492d292b5da84c28a27c100a0,757,118,610,0,1485,Wilcoxe018b2b28cf44efa764c48801c922205bfa7ea9492d292b5da84c28a27c100a0
Wilkes,e018b2b28cf44efa764c48801c922205bfa7ea9492d292b5da84c28a27c100a0,1032,86,1011,4,2133,Wilkese018b2b28cf44efa764c48801c922205bfa7ea9492d292b5da84c28a27c100a0
Wilkinson,e018b2b28cf44efa764c48801c922205bfa7ea9492d292b5da84c28a27c100a0,1177,111,683,1,1972,Wilkinsone018b2b28cf44efa764c48801c922205bfa7ea9492d292b5da84c28a27c100a0
Worth,e018b2b28cf44efa764c48801c922205bfa7ea9492d292b5da84c28a27c100a0,2442,156,2038,7,4643,Worthe018b2b28cf44efa764c48801c922205bfa7ea9492d292b5da84c28a27c100a0
Appling,999416fc021c1d68a856ccdf390c45d30a100bb4946254d4fbdbe36559f7eed0,1359,160,899,0,2418,Appling999416fc021c1d68a856ccdf390c45d30a100bb4946254d4fbdbe36559f7eed0
Atkinson,999416fc021c1d68a856ccdf390c45d30a100bb4946254d4fbdbe36559f7eed0,409,30,475,0,914,Atkinson999416fc021c1d68a856ccdf390c45d30a100bb4946254d4fbdbe36559f7eed0
Bacon,999416fc021c1d68a856ccdf390c45d30a100bb4946254d4fbdbe36559f7eed0,439,42,745,1,1227,Bacon999416fc021c1d68a856ccdf390c45d30a100bb4946254d4fbdbe36559f7eed0
Baker,999416fc021c1d68a856ccdf390c45d30a100bb4946254d4fbdbe36559f7eed0,263,53,215,0,531,Baker999416fc021c1d68a856ccdf390c45d30a100bb4946254d4fbdbe36559f7eed0
Baldwin,999416fc021c1d68a856ccdf390c45d30a100bb4946254d4fbdbe36559f7eed0,2492,544,3378,3,6417,Baldwin999416fc021c1d68a856ccdf390c45d30a100bb4946254d4fbdbe36559f7eed0
Banks,999416fc021c1d68a856ccdf390c45d30a100bb4946254d4fbdbe36559f7eed0,1312,73,1250,0,2635,Banks999416fc021c1d68a856ccdf390c45d30a100bb4946254d4fbdbe36559f7eed0
Barrow,999416fc021c1d68a856ccdf390c45d30a100bb4946254d4fbdbe36559f7eed0,4050,320,4576,1,8947,Barrow999416fc021c1d68a856ccdf390c45d30a100bb4946254d4fbdbe36559f7eed0
Bartow,999416fc021c1d68a856ccdf390c45d30a100bb4946254d4fbdbe36559f7eed0,7168,466,5902,7,13543,Bartow999416fc021c1d68a856ccdf390c45d30a100bb4946254d4fbdbe36559f7eed0
Ben Hill,999416fc021c1d68a856ccdf390c45d30a100bb4946254d4fbdbe36559f7eed0,562,69,1596,1,2228,Ben Hill999416fc021c1d68a856ccdf390c45d30a100bb4946254d4fbdbe36559f7eed0
Berrien,999416fc021c1d68a856ccdf390c45d30a100bb4946254d4fbdbe36559f7eed0,1059,113,1179,1,2352,Berrien999416fc021c1d68a856ccdf390c45d30a100bb4946254d4fbdbe36559f7eed0
Bibb,999416fc021c1d68a856ccdf390c45d30a100bb4946254d4fbdbe36559f7eed0,11044,1298,10787,66,23195,Bibb999416fc021c1d68a856ccdf390c45d30a100bb4946254d4fbdbe36559f7eed0
Bleckley,999416fc021c1d68a856ccdf390c45d30a100bb4946254d4fbdbe36559f7eed0,728,99,853,1,1681,Bleckley999416fc021c1d68a856ccdf390c45d30a100bb4946254d4fbdbe36559f7eed0
Brantley,999416fc021c1d68a856ccdf390c45d30a100bb4946254d4fbdbe36559f7eed0,974,70,1039,2,2085,Brantley999416fc021c1d68a856ccdf390c45d30a100bb4946254d4fbdbe36559f7eed0
Brooks,999416fc021c1d68a856ccdf390c45d30a100bb4946254d4fbdbe36559f7eed0,953,165,830,15,1963,Brooks999416fc021c1d68a856ccdf390c45d30a100bb4946254d4fbdbe36559f7eed0
Bryan,999416fc021c1d68a856ccdf390c45d30a100bb4946254d4fbdbe36559f7eed0,1659,158,2379,2,4198,Bryan999416fc021c1d68a856ccdf390c45d30a100bb4946254d4fbdbe36559f7eed0
Bulloch,999416fc021c1d68a856ccdf390c45d30a100bb4946254d4fbdbe36559f7eed0,4203,330,4388,9,8930,Bulloch999416fc021c1d68a856ccdf390c45d30a100bb4946254d4fbdbe36559f7eed0
Burke,999416fc021c1d68a856ccdf390c45d30a100bb4946254d4fbdbe36559f7eed0,1734,384,1286,0,3404,Burke999416fc021c1d68a856ccdf390c45d30a100bb4946254d4fbdbe36559f7eed0
Butts,999416fc021c1d68a856ccdf390c45d30a100bb4946254d4fbdbe36559f7eed0,848,91,2080,0,3019,Butts999416fc021c1d68a856ccdf390c45d30a100bb4946254d4fbdbe36559f7eed0
Calhoun,999416fc021c1d68a856ccdf390c45d30a100bb4946254d4fbdbe36559f7eed0,514,51,262,0,827,Calhoun999416fc021c1d68a856ccdf390c45d30a100bb4946254d4fbdbe36559f7eed0
Camden,999416fc021c1d68a856ccdf390c45d30a100bb4946254d4fbdbe36559f7eed0,2212,300,3291,4,5807,Camden999416fc021c1d68a856ccdf390c45d30a100bb4946254d4fbdbe36559f7eed0
Candler,999416fc021c1d68a856ccdf390c45d30a100bb4946254d4fbdbe36559f7eed0,308,42,892,0,1242,Candler999416fc021c1d68a856ccdf390c45d30a100bb4946254d4fbdbe36559f7eed0
Carroll,999416fc021c1d68a856ccdf390c45d30a100bb4946254d4fbdbe36559f7eed0,6707,463,8053,17,15240,Carroll999416fc021c1d68a856ccdf390c45d30a100bb4946254d4fbdbe36559f7eed0
Catoosa,999416fc021c1d68a856ccdf390c45d30a100bb4946254d4fbdbe36559f7eed0,2737,157,4875,3,7772,Catoosa999416fc021c1d68a856ccdf390c45d30a100bb4946254d4fbdbe36559f7eed0
Charlton,999416fc021c1d68a856ccdf390c45d30a100bb4946254d4fbdbe36559f7eed0,591,71,707,3,1372,Charlton999416fc021c1d68a856ccdf390c45d30a100bb4946254d4fbdbe36559f7eed0
Chatham,999416fc021c1d68a856ccdf390c45d30a100bb4946254d4fbdbe36559f7eed0,27277,1567,12102,34,40980,Chatham999416fc021c1d68a856ccdf390c45d30a100bb4946254d4fbdbe36559f7eed0
Chattahoochee,999416fc021c1d68a856ccdf390c45d30a100bb4946254d4fbdbe36559f7eed0,217,4,167,2,390,Chattahoochee999416fc021c1d68a856ccdf390c45d30a100bb4946254d4fbdbe36559f7eed0
Chattooga,999416fc021c1d68a856ccdf390c45d30a100bb4946254d4fbdbe36559f7eed0,1355,61,1288,2,2706,Chattooga999416fc021c1d68a856ccdf390c45d30a100bb4946254d4fbdbe36559f7eed0
Cherokee,999416fc021c1d68a856ccdf390c45d30a100bb4946254d4fbdbe36559f7eed0,15335,1594,20066,6,37001,Cherokee999416fc021c1d68a856ccdf390c45d30a100bb4946254d4fbdbe36559f7eed0
Clarke,999416fc021c1d68a856ccdf390c45d30a100bb4946254d4fbdbe36559f7eed0,8732,1028,11431,41,21232,Clarke999416fc021c1d68a856ccdf390c45d30a100bb4946254d4fbdbe36559f7eed0
Clay,999416fc021c1d68a856ccdf390c45d30a100bb4946254d4fbdbe36559f7eed0,167,20,220,2,409,Clay999416fc021c1d68a856ccdf390c45d30a100bb4946254d4fbdbe36559f7eed0
Clayton,999416fc021c1d68a856ccdf390c45d30a100bb4946254d4fbdbe36559f7eed0,9328,776,16094,42,26240,Clayton999416fc021c1d68a856ccdf390c45d30a100bb4946254d4fbdbe36559f7eed0
Clinch,999416fc021c1d68a856ccdf390c45d30a100bb4946254d4fbdbe36559f7eed0,304,32,477,1,814,Clinch999416fc021c1d68a856ccdf390c45d30a100bb4946254d4fbdbe36559f7eed0
Cobb,999416fc021c1d68a856ccdf390c45d30a100bb4946254d4fbdbe36559f7eed0,60908,7411,48102,211,116632,Cobb999416fc021c1d68a856ccdf390c45d30a100bb4946254d4fbdbe36559f7eed0
Coffee,999416fc021c1d68a856ccdf390c45d30a100bb4946254d4fbdbe36559f7eed0,1671,140,2811,0,4622,Coffee999416fc021c1d68a856ccdf390c45d30a100bb4946254d4fbdbe36559f7eed0
Colquitt,999416fc021c1d68a856ccdf390c45d30a100bb4946254d4fbdbe36559f7eed0,2607,119,2287,1,5014,Colquitt999416fc021c1d68a856ccdf390c45d30a100bb4946254d4fbdbe36559f7eed0
Columbia,999416fc021c1d68a856ccdf390c45d30a100bb4946254d4fbdbe36559f7eed0,7979,824,9450,3,18256,Columbia999416fc021c1d68a856ccdf390c45d30a100bb4946254d4fbdbe36559f7eed0
Cook,999416fc021c1d68a856ccdf390c45d30a100bb4946254d4fbdbe36559f7eed0,924,68,1139,0,2131,Cook999416fc021c1d68a856ccdf390c45d30a100bb4946254d4fbdbe36559f7eed0
Coweta,999416fc021c1d68a856ccdf390c45d30a100bb4946254d4fbdbe36559f7eed0,9713,850,10266,4,20833,Coweta999416fc021c1d68a856ccdf390c45d30a100bb4946254d4fbdbe36559f7eed0
Crawford,999416fc021c1d68a856ccdf390c45d30a100bb4946254d4fbdbe36559f7eed0,778,74,965,1,1818,Crawford999416fc021c1d68a856ccdf390c45d30a100bb4946254d4fbdbe36559f7eed0
Crisp,999416fc021c1d68a856ccdf390c45d30a100bb4946254d4fbdbe36559f7eed0,761,99,1489,2,2351,Crisp999416fc021c1d68a856ccdf390c45d30a100bb4946254d4fbdbe36559f7eed0
Dade,999416fc021c1d68a856ccdf390c45d30a100bb4946254d4fbdbe36559f7eed0,935,36,830,1,1802,Dade999416fc021c1d68a856ccdf390c45d30a100bb4946254d4fbdbe36559f7eed0
Dawson,999416fc021c1d68a856ccdf390c45d30a100bb4946254d4fbdbe36559f7eed0,927,179,2640,2,3748,Dawson999416fc021c1d68a856ccdf390c45d30a100bb4946254d4fbdbe36559f7eed0
Decatur,999416fc021c1d68a856ccdf390c45d30a100bb4946254d4fbdbe36559f7eed0,1483,158,2082,11,3734,Decatur999416fc021c1d68a856ccdf390c45d30a100bb4946254d4fbdbe36559f7eed0
DeKalb,999416fc021c1d68a856ccdf390c45d30a100bb4946254d4fbdbe36559f7eed0,46270,5246,66477,140,118133,DeKalb999416fc021c1d68a856ccdf390c45d30a100bb4946254d4fbdbe36559f7eed0
Dodge,999416fc021c1d68a856ccdf390c45d30a100bb4946254d4fbdbe36559f7eed0,1468,118,1084,0,2670,Dodge999416fc021c1d68a856ccdf390c45d30a100bb4946254d4fbdbe36559f7eed0
Dooly,999416fc021c1d68a856ccdf390c45d30a100bb4946254d4fbdbe36559f7eed0,574,49,571,3,1197,Dooly999416fc021c1d68a856ccdf390c45d30a100bb4946254d4fbdbe36559f7eed0
Dougherty,999416fc021c1d68a856ccdf390c45d30a100bb4946254d4fbdbe36559f7eed0,6586,501,4935,21,12043,Dougherty999416fc021c1d68a856ccdf390c45d30a100bb4946254d4fbdbe36559f7eed0
Douglas,999416fc021c1d68a856ccdf390c45d30a100bb4946254d4fbdbe36559f7eed0,6340,685,12012,12,19049,Douglas999416fc021c1d68a856ccdf390c45d30a100bb4946254d4fbdbe36559f7eed0
Early,999416fc021c1d68a856ccdf390c45d30a100bb4946254d4fbdbe36559f7eed0,811,88,799,0,1698,Early999416fc021c1d68a856ccdf390c45d30a100bb4946254d4fbdbe36559f7eed0
Echols,999416fc021c1d68a856ccdf390c45d30a100bb4946254d4fbdbe36559f7eed0,138,16,239,0,393,Echols999416fc021c1d68a856ccdf390c45d30a100bb4946254d4fbdbe36559f7eed0
Effingham,999416fc021c1d68a856ccdf390c45d30a100bb4946254d4fbdbe36559f7eed0,3422,182,3315,1,6920,Effingham999416fc021c1d68a856ccdf390c45d30a100bb4946254d4fbdbe36559f7eed0
Elbert,999416fc021c1d68a856ccdf390c45d30a100bb4946254d4fbdbe36559f7eed0,1115,155,1663,14,2947,Elbert999416fc021c1d68a856ccdf390c45d30a100bb4946254d4fbdbe36559f7eed0
Emanuel,999416fc021c1d68a856ccdf390c45d30a100bb4946254d4fbdbe36559f7eed0,1354,103,1102,4,2563,Emanuel999416fc021c1d68a856ccdf390c45d30a100bb4946254d4fbdbe36559f7eed0
Evans,999416fc021c1d68a856ccdf390c45d30a100bb4946254d4fbdbe36559f7eed0,385,69,846,0,1300,Evans999416fc021c1d68a856ccdf390c45d30a100bb4946254d4fbdbe36559f7eed0
Fannin,999416fc021c1d68a856ccdf390c45d30a100bb4946254d4fbdbe36559f7eed0,1794,234,1831,6,3865,Fannin999416fc021c1d68a856ccdf390c45d30a100bb4946254d4fbdbe36559f7eed0
Fayette,999416fc021c1d68a856ccdf390c45d30a100bb4946254d4fbdbe36559f7eed0,6975,890,14180,2,22047,Fayette999416fc021c1d68a856ccdf390c45d30a100bb4946254d4fbdbe36559f7eed0
Floyd,999416fc021c1d68a856ccdf390c45d30a100bb4946254d4fbdbe36559f7eed0,5155,408,6755,22,12340,Floyd999416fc021c1d68a856ccdf390c45d30a100bb4946254d4fbdbe36559f7eed0
Forsyth,999416fc021c1d68a856ccdf390c45d30a100bb4946254d4fbdbe36559f7eed0,8043,1094,21173,12,30322,Forsyth999416fc021c1d68a856ccdf390c45d30a100bb4946254d4fbdbe36559f7eed0
Franklin,999416fc021c1d68a856ccdf390c45d30a100bb4946254d4fbdbe36559f7eed0,1387,115,1375,0,2877,Franklin999416fc021c1d68a856ccdf390c45d30a100bb4946254d4fbdbe36559f7eed0
Fulton,999416fc021c1d68a856ccdf390c45d30a100bb4946254d4fbdbe36559f7eed0,55810,6396,87222,340,149768,Fulton999416fc021c1d68a856ccdf390c45d30a100bb4946254d4fbdbe36559f7eed0
Gilmer,999416fc021c1d68a856ccdf390c45d30a100bb4946254d4fbdbe36559f7eed0,1920,162,2226,4,4312,Gilmer999416fc021c1d68a856ccdf390c45d30a100bb4946254d4fbdbe36559f7eed0
Glascock,999416fc021c1d68a856ccdf390c45d30a100bb4946254d4fbdbe36559f7eed0,190,31,214,0,435,Glascock999416fc021c1d68a856ccdf390c45d30a100bb4946254d4fbdbe36559f7eed0
Glynn,999416fc021c1d68a856ccdf390c45d30a100bb4946254d4fbdbe36559f7eed0,4939,416,6160,20,11535,Glynn999416fc021c1d68a856ccdf390c45d30a100bb4946254d4fbdbe36559f7eed0
Gordon,999416fc021c1d68a856ccdf390c45d30a100bb4946254d4fbdbe36559f7eed0,3031,170,2901,5,6107,Gordon999416fc021c1d68a856ccdf390c45d30a100bb4946254d4fbdbe36559f7eed0
Grady,999416fc021c1d68a856ccdf390c45d30a100bb4946254d4fbdbe36559f7eed0,1408,94,1709,3,3214,Grady999416fc021c1d68a856ccdf390c45d30a100bb4946254d4fbdbe36559f7eed0
Greene,999416fc021c1d68a856ccdf390c45d30a100bb4946254d4fbdbe36559f7eed0,937,245,1707,3,2892,Greene999416fc021c1d68a856ccdf390c45d30a100bb4946254d4fbdbe36559f7eed0
Gwinnett,999416fc021c1d68a856ccdf390c45d30a100bb4946254d4fbdbe36559f7eed0,51611,5664,46328,357,103960,Gwinnett999416fc021c1d68a856ccdf390c45d30a100bb4946254d4fbdbe36559f7eed0
Habersham,999416fc021c1d68a856ccdf390c45d30a100bb4946254d4fbdbe36559f7eed0,1055,257,3906,1,5219,Habersham999416fc021c1d68a856ccdf390c45d30a100bb4946254d4fbdbe36559f7eed0
Hall,999416fc021c1d68a856ccdf390c45d30a100bb4946254d4fbdbe36559f7eed0,11207,1109,11448,22,23786,Hall999416fc021c1d68a856ccdf390c45d30a100bb4946254d4fbdbe36559f7eed0
Hancock,999416fc021c1d68a856ccdf390c45d30a100bb4946254d4fbdbe36559f7eed0,662,147,545,1,1355,Hancock999416fc021c1d68a856ccdf390c45d30a100bb4946254d4fbdbe36559f7eed0
Haralson,999416fc021c1d68a856ccdf390c45d30a100bb4946254d4fbdbe36559f7eed0,2105,130,1925,1,4161,Haralson999416fc021c1d68a856ccdf390c45d30a100bb4946254d4fbdbe36559f7eed0
Harris,999416fc021c1d68a856ccdf390c45d30a100bb4946254d4fbdbe36559f7eed0,2149,194,2658,1,5002,Harris999416fc021c1d68a856ccdf390c45d30a100bb4946254d4fbdbe36559f7eed0
Hart,999416fc021c1d68a856ccdf390c45d30a100bb4946254d4fbdbe36559f7eed0,1530,135,1942,0,3607,Hart999416fc021c1d68a856ccdf390c45d30a100bb4946254d4fbdbe36559f7eed0
Heard,999416fc021c1d68a856ccdf390c45d30a100bb4946254d4fbdbe36559f7eed0,780,77,531,0,1388,Heard999416fc021c1d68a856ccdf390c45d30a100bb4946254d4fbdbe36559f7eed0
Henry,999416fc021c1d68a856ccdf390c45d30a100bb4946254d4fbdbe36559f7eed0,8551,1075,22543,65,32234,Henry999416fc021c1d68a856ccdf390c45d30a100bb4946254d4fbdbe36559f7eed0
Houston,999416fc021c1d68a856ccdf390c45d30a100bb4946254d4fbdbe36559f7eed0,6249,783,13131,21,20184,Houston999416fc021c1d68a856ccdf390c45d30a100bb4946254d4fbdbe36559f7eed0
Irwin,999416fc021c1d68a856ccdf390c45d30a100bb4946254d4fbdbe36559f7eed0,755,41,730,1,1527,Irwin999416fc021c1d68a856ccdf390c45d30a100bb4946254d4fbdbe36559f7eed0
Jackson,999416fc021c1d68a856ccdf390c45d30a100bb4946254d4fbdbe36559f7eed0,3533,260,5680,10,9483,Jackson999416fc021c1d68a856ccdf390c45d30a100bb4946254d4fbdbe36559f7eed0
Jasper,999416fc021c1d68a856ccdf390c45d30a100bb4946254d4fbdbe36559f7eed0,817,147,1285,4,2253,Jasper999416fc021c1d68a856ccdf390c45d30a100bb4946254d4fbdbe36559f7eed0
Jeff Davis,999416fc021c1d68a856ccdf390c45d30a100bb4946254d4fbdbe36559f7eed0,802,52,811,0,1665,Jeff Davis999416fc021c1d68a856ccdf390c45d30a100bb4946254d4fbdbe36559f7eed0
Jefferson,999416fc021c1d68a856ccdf390c45d30a100bb4946254d4fbdbe36559f7eed0,1352,162,1107,5,2626,Jefferson999416fc021c1d68a856ccdf390c45d30a100bb4946254d4fbdbe36559f7eed0
Jenkins,999416fc021c1d68a856ccdf390c45d30a100bb4946254d4fbdbe36559f7eed0,402,61,517,5,985,Jenkins999416fc021c1d68a856ccdf390c45d30a100bb4946254d4fbdbe36559f7eed0
Johnson,999416fc021c1d68a856ccdf390c45d30a100bb4946254d4fbdbe36559f7eed0,564,76,777,0,1417,Johnson999416fc021c1d68a856ccdf390c45d30a100bb4946254d4fbdbe36559f7eed0
Jones,999416fc021c1d68a856ccdf390c45d30a100bb4946254d4fbdbe36559f7eed0,1739,193,2681,0,4613,Jones999416fc021c1d68a856ccdf390c45d30a100bb4946254d4fbdbe36559f7eed0
Lamar,999416fc021c1d68a856ccdf390c45d30a100bb4946254d4fbdbe36559f7eed0,1128,129,1573,2,2832,Lamar999416fc021c1d68a856ccdf390c45d30a100bb4946254d4fbdbe36559f7eed0
Lanier,999416fc021c1d68a856ccdf390c45d30a100bb4946254d4fbdbe36559f7eed0,381,18,509,1,909,Lanier999416fc021c1d68a856ccdf390c45d30a100bb4946254d4fbdbe36559f7eed0
Laurens,999416fc021c1d68a856ccdf390c45d30a100bb4946254d4fbdbe36559f7eed0,3924,398,3311,2,7635,Laurens999416fc021c1d68a856ccdf390c45d30a100bb4946254d4fbdbe36559f7eed0
Lee,999416fc021c1d68a856ccdf390c45d30a100bb4946254d4fbdbe36559f7eed0,2264,144,2308,2,4718,Lee999416fc021c1d68a856ccdf390c45d30a100bb4946254d4fbdbe36559f7eed0
Liberty,999416fc021c1d68a856ccdf390c45d30a100bb4946254d4fbdbe36559f7eed0,1819,177,2716,16,4728,Liberty999416fc021c1d68a856ccdf390c45d30a100bb4946254d4fbdbe36559f7eed0
Lincoln,999416fc021c1d68a856ccdf390c45d30a100bb4946254d4fbdbe36559f7eed0,537,157,707,1,1402,Lincoln999416fc021c1d68a856ccdf390c45d30a100bb4946254d4fbdbe36559f7eed0
Long,999416fc021c1d68a856ccdf390c45d30a100bb4946254d4fbdbe36559f7eed0,590,29,543,2,1164,Long999416fc021c1d68a856ccdf390c45d30a100bb4946254d4fbdbe36559f7eed0
Lowndes,999416fc021c1d68a856ccdf390c45d30a100bb4946254d4fbdbe36559f7eed0,4004,429,8081,166,12680,Lowndes999416fc021c1d68a856ccdf390c45d30a100bb4946254d4fbdbe36559f7eed0
Lumpkin,999416fc021c1d68a856ccdf390c45d30a100bb4946254d4fbdbe36559f7eed0,998,190,3325,2,4515,Lumpkin999416fc021c1d68a856ccdf390c45d30a100bb4946254d4fbdbe36559f7eed0
Macon,999416fc021c1d68a856ccdf390c45d30a100bb4946254d4fbdbe36559f7eed0,554,74,706,0,1334,Macon999416fc021c1d68a856ccdf390c45d30a100bb4946254d4fbdbe36559f7eed0
Madison,999416fc021c1d68a856ccdf390c45d30a100bb4946254d4fbdbe36559f7eed0,2109,177,2366,1,4653,Madison999416fc021c1d68a856ccdf390c45d30a100bb4946254d4fbdbe36559f7eed0
Marion,999416fc021c1d68a856ccdf390c45d30a100bb4946254d4fbdbe36559f7eed0,574,89,429,0,1092,Marion999416fc021c1d68a856ccdf390c45d30a100bb4946254d4fbdbe36559f7eed0
McDuffie,999416fc021c1d68a856ccdf390c45d30a100bb4946254d4fbdbe36559f7eed0,1039,171,1792,0,3002,McDuffie999416fc021c1d68a856ccdf390c45d30a100bb4946254d4fbdbe36559f7eed0
McIntosh,999416fc021c1d68a856ccdf390c45d30a100bb4946254d4fbdbe36559f7eed0,863,186,1067,2,2118,McIntosh999416fc021c1d68a856ccdf390c45d30a100bb4946254d4fbdbe36559f7eed0
Meriwether,999416fc021c1d68a856ccdf390c45d30a100bb4946254d4fbdbe36559f7eed0,1863,111,1129,2,3105,Meriwether999416fc021c1d68a856ccdf390c45d30a100bb4946254d4fbdbe36559f7eed0
Miller,999416fc021c1d68a856ccdf390c45d30a100bb4946254d4fbdbe36559f7eed0,387,40,423,1,851,Miller999416fc021c1d68a856ccdf390c45d30a100bb4946254d4fbdbe36559f7eed0
Mitchell,999416fc021c1d68a856ccdf390c45d30a100bb4946254d4fbdbe36559f7eed0,1325,236,1335,3,2899,Mitchell999416fc021c1d68a856ccdf390c45d30a100bb4946254d4fbdbe36559f7eed0
Monroe,999416fc021c1d68a856ccdf390c45d30a100bb4946254d4fbdbe36559f7eed0,2223,187,2293,4,4707,Monroe999416fc021c1d68a856ccdf390c45d30a100bb4946254d4fbdbe36559f7eed0
Montgomery,999416fc021c1d68a856ccdf390c45d30a100bb4946254d4fbdbe36559f7eed0,798,44,449,0,1291,Montgomery999416fc021c1d68a856ccdf390c45d30a100bb4946254d4fbdbe36559f7eed0
Morgan,999416fc021c1d68a856ccdf390c45d30a100bb4946254d4fbdbe36559f7eed0,1399,130,2086,1,3616,Morgan999416fc021c1d68a856ccdf390c45d30a100bb4946254d4fbdbe36559f7eed0
Murray,999416fc021c1d68a856ccdf390c45d30a100bb4946254d4fbdbe36559f7eed0,2066,85,1697,0,3848,Murray999416fc021c1d68a856ccdf390c45d30a100bb4946254d4fbdbe36559f7eed0
Muscogee,999416fc021c1d68a856ccdf390c45d30a100bb4946254d4fbdbe36559f7eed0,10095,1171,11411,31,22708,Muscogee999416fc021c1d68a856ccdf390c45d30a100bb4946254d4fbdbe36559f7eed0
Newton,999416fc021c1d68a856ccdf390c45d30a100bb4946254d4fbdbe36559f7eed0,6811,619,7555,0,14985,Newton999416fc021c1d68a856ccdf390c45d30a100bb4946254d4fbdbe36559f7eed0
Oconee,999416fc021c1d68a856ccdf390c45d30a100bb4946254d4fbdbe36559f7eed0,3229,314,4717,4,8264,Oconee999416fc021c1d68a856ccdf390c45d30a100bb4946254d4fbdbe36559f7eed0
Oglethorpe,999416fc021c1d68a856ccdf390c45d30a100bb4946254d4fbdbe36559f7eed0,1031,118,1595,0,2744,Oglethorpe999416fc021c1d68a856ccdf390c45d30a100bb4946254d4fbdbe36559f7eed0
Paulding,999416fc021c1d68a856ccdf390c45d30a100bb4946254d4fbdbe36559f7eed0,6015,864,13443,5,20327,Paulding999416fc021c1d68a856ccdf390c45d30a100bb4946254d4fbdbe36559f7eed0
Peach,999416fc021c1d68a856ccdf390c45d30a100bb4946254d4fbdbe36559f7eed0,1092,122,2412,7,3633,Peach999416fc021c1d68a856ccdf390c45d30a100bb4946254d4fbdbe36559f7eed0
Pickens,999416fc021c1d68a856ccdf390c45d30a100bb4946254d4fbdbe36559f7eed0,1765,83,2907,1,4756,Pickens999416fc021c1d68a856ccdf390c45d30a100bb4946254d4fbdbe36559f7eed0
Pierce,999416fc021c1d68a856ccdf390c45d30a100bb4946254d4fbdbe36559f7eed0,766,120,1853,0,2739,Pierce999416fc021c1d68a856ccdf390c45d30a100bb4946254d4fbdbe36559f7eed0
Pike,999416fc021c1d68a856ccdf390c45d30a100bb4946254d4fbdbe36559f7eed0,1291,123,2091,1,3506,Pike999416fc021c1d68a856ccdf390c45d30a100bb4946254d4fbdbe36559f7eed0
Polk,999416fc021c1d68a856ccdf390c45d30a100bb4946254d4fbdbe36559f7eed0,1564,150,3119,2,4835,Polk999416fc021c1d68a856ccdf390c45d30a100bb4946254d4fbdbe36559f7eed0
Pulaski,999416fc021c1d68a856ccdf390c45d30a100bb4946254d4fbdbe36559f7eed0,271,62,843,0,1176,Pulaski999416fc021c1d68a856ccdf390c45d30a100bb4946254d4fbdbe36559f7eed0
Putnam,999416fc021c1d68a856ccdf390c45d30a100bb4946254d4fbdbe36559f7eed0,1193,207,1933,1,3334,Putnam999416fc021c1d68a856ccdf390c45d30a100bb4946254d4fbdbe36559f7eed0
Quitman,999416fc021c1d68a856ccdf390c45d30a100bb4946254d4fbdbe36559f7eed0,164,11,133,0,308,Quitman999416fc021c1d68a856ccdf390c45d30a100bb4946254d4fbdbe36559f7eed0
Rabun,999416fc021c1d68a856ccdf390c45d30a100bb4946254d4fbdbe36559f7eed0,442,226,1921,0,2589,Rabun999416fc021c1d68a856ccdf390c45d30a100bb4946254d4fbdbe36559f7eed0
Randolph,999416fc021c1d68a856ccdf390c45d30a100bb4946254d4fbdbe36559f7eed0,477,42,379,1,899,Randolph999416fc021c1d68a856ccdf390c45d30a100bb4946254d4fbdbe36559f7eed0
Richmond,999416fc021c1d68a856ccdf390c45d30a100bb4946254d4fbdbe36559f7eed0,11330,1220,11045,23,23618,Richmond999416fc021c1d68a856ccdf390c45d30a100bb4946254d4fbdbe36559f7eed0
Rockdale,999416fc021c1d68a856ccdf390c45d30a100bb4946254d4fbdbe36559f7eed0,3466,432,9007,11,12916,Rockdale999416fc021c1d68a856ccdf390c45d30a100bb4946254d4fbdbe36559f7eed0
Schley,999416fc021c1d68a856ccdf390c45d30a100bb4946254d4fbdbe36559f7eed0,211,32,456,0,699,Schley999416fc021c1d68a856ccdf390c45d30a100bb4946254d4fbdbe36559f7eed0
Screven,999416fc021c1d68a856ccdf390c45d30a100bb4946254d4fbdbe36559f7eed0,944,61,970,0,1975,Screven999416fc021c1d68a856ccdf390c45d30a100bb4946254d4fbdbe36559f7eed0
Seminole,999416fc021c1d68a856ccdf390c45d30a100bb4946254d4fbdbe36559f7eed0,642,58,406,1,1107,Seminole999416fc021c1d68a856ccdf390c45d30a100bb4946254d4fbdbe36559f7eed0
Spalding,999416fc021c1d68a856ccdf390c45d30a100bb4946254d4fbdbe36559f7eed0,3379,359,5630,4,9372,Spalding999416fc021c1d68a856ccdf390c45d30a100bb4946254d4fbdbe36559f7eed0
Stephens,999416fc021c1d68a856ccdf390c45d30a100bb4946254d4fbdbe36559f7eed0,609,180,2369,0,3158,Stephens999416fc021c1d68a856ccdf390c45d30a100bb4946254d4fbdbe36559f7eed0
Stewart,999416fc021c1d68a856ccdf390c45d30a100bb4946254d4fbdbe36559f7eed0,276,74,225,2,577,Stewart999416fc021c1d68a856ccdf390c45d30a100bb4946254d4fbdbe36559f7eed0
Sumter,999416fc021c1d68a856ccdf390c45d30a100bb4946254d4fbdbe36559f7eed0,1830,286,2123,0,4239,Sumter999416fc021c1d68a856ccdf390c45d30a100bb4946254d4fbdbe36559f7eed0
Talbot,999416fc021c1d68a856ccdf390c45d30a100bb4946254d4fbdbe36559f7eed0,627,119,258,0,1004,Talbot999416fc021c1d68a856ccdf390c45d30a100bb4946254d4fbdbe36559f7eed0
Taliaferro,999416fc021c1d68a856ccdf390c45d30a100bb4946254d4fbdbe36559f7eed0,123,26,144,1,294,Taliaferro999416fc021c1d68a856ccdf390c45d30a100bb4946254d4fbdbe36559f7eed0
Tattnall,999416fc021c1d68a856ccdf390c45d30a100bb4946254d4fbdbe36559f7eed0,997,199,1318,3,2517,Tattnall999416fc021c1d68a856ccdf390c45d30a100bb4946254d4fbdbe36559f7eed0
Taylor,999416fc021c1d68a856ccdf390c45d30a100bb4946254d4fbdbe36559f7eed0,490,64,689,0,1243,Taylor999416fc021c1d68a856ccdf390c45d30a100bb4946254d4fbdbe36559f7eed0
Telfair,999416fc021c1d68a856ccdf390c45d30a100bb4946254d4fbdbe36559f7eed0,720,115,589,1,1425,Telfair999416fc021c1d68a856ccdf390c45d30a100bb4946254d4fbdbe36559f7eed0
Terrell,999416fc021c1d68a856ccdf390c45d30a100bb4946254d4fbdbe36559f7eed0,644,90,617,0,1351,Terrell999416fc021c1d68a856ccdf390c45d30a100bb4946254d4fbdbe36559f7eed0
Thomas,999416fc021c1d68a856ccdf390c45d30a100bb4946254d4fbdbe36559f7eed0,2418,279,3477,1,6175,Thomas999416fc021c1d68a856ccdf390c45d30a100bb4946254d4fbdbe36559f7eed0
Tift,999416fc021c1d68a856ccdf390c45d30a100bb4946254d4fbdbe36559f7eed0,1915,163,2661,3,4742,Tift999416fc021c1d68a856ccdf390c45d30a100bb4946254d4fbdbe36559f7eed0
Toombs,999416fc021c1d68a856ccdf390c45d30a100bb4946254d4fbdbe36559f7eed0,1317,190,1635,1,3143,Toombs999416fc021c1d68a856ccdf390c45d30a100bb4946254d4fbdbe36559f7eed0
Towns,999416fc021c1d68a856ccdf390c45d30a100bb4946254d4fbdbe36559f7eed0,625,98,1428,2,2153,Towns999416fc021c1d68a856ccdf390c45d30a100bb4946254d4fbdbe36559f7eed0
Treutlen,999416fc021c1d68a856ccdf390c45d30a100bb4946254d4fbdbe36559f7eed0,328,45,550,1,924,Treutlen999416fc021c1d68a856ccdf390c45d30a100bb4946254d4fbdbe36559f7eed0
Troup,999416fc021c1d68a856ccdf390c45d30a100bb4946254d4fbdbe36559f7eed0,4022,372,4375,64,8833,Troup999416fc021c1d68a856ccdf390c45d30a100bb4946254d4fbdbe36559f7eed0
Turner,999416fc021c1d68a856ccdf390c45d30a100bb4946254d4fbdbe36559f7eed0,440,31,770,1,1242,Turner999416fc021c1d68a856ccdf390c45d30a100bb4946254d4fbdbe36559f7eed0
Twiggs,999416fc021c1d68a856ccdf390c45d30a100bb4946254d4fbdbe36559f7eed0,832,106,591,0,1529,Twiggs999416fc021c1d68a856ccdf390c45d30a100bb4946254d4fbdbe36559f7eed0
Union,999416fc021c1d68a856ccdf390c45d30a100bb4946254d4fbdbe36559f7eed0,1547,187,2604,2,4340,Union999416fc021c1d68a856ccdf390c45d30a100bb4946254d4fbdbe36559f7eed0
Upson,999416fc021c1d68a856ccdf390c45d30a100bb4946254d4fbdbe36559f7eed0,1106,150,2904,5,4165,Upson999416fc021c1d68a856ccdf390c45d30a100bb4946254d4fbdbe36559f7eed0
Walker,999416fc021c1d68a856ccdf390c45d30a100bb4946254d4fbdbe36559f7eed0,2832,264,4355,2,7453,Walker999416fc021c1d68a856ccdf390c45d30a100bb4946254d4fbdbe36559f7eed0
Walton,999416fc021c1d68a856ccdf390c45d30a100bb4946254d4fbdbe36559f7eed0,7050,499,5551,10,13110,Walton999416fc021c1d68a856ccdf390c45d30a100bb4946254d4fbdbe36559f7eed0
Ware,999416fc021c1d68a856ccdf390c45d30a100bb4946254d4fbdbe36559f7eed0,1678,176,2123,4,3981,Ware999416fc021c1d68a856ccdf390c45d30a100bb4946254d4fbdbe36559f7eed0
Warren,999416fc021c1d68a856ccdf390c45d30a100bb4946254d4fbdbe36559f7eed0,342,30,436,0,808,Warren999416fc021c1d68a856ccdf390c45d30a100bb4946254d4fbdbe36559f7eed0
Washington,999416fc021c1d68a856ccdf390c45d30a100bb4946254d4fbdbe36559f7eed0,1490,246,1580,8,3324,Washington999416fc021c1d68a856ccdf390c45d30a100bb4946254d4fbdbe36559f7eed0
Wayne,999416fc021c1d68a856ccdf390c45d30a100bb4946254d4fbdbe36559f7eed0,1543,146,2030,3,3722,Wayne999416fc021c1d68a856ccdf390c45d30a100bb4946254d4fbdbe36559f7eed0
Webster,999416fc021c1d68a856ccdf390c45d30a100bb4946254d4fbdbe36559f7eed0,150,33,179,1,363,Webster999416fc021c1d68a856ccdf390c45d30a100bb4946254d4fbdbe36559f7eed0
Wheeler,999416fc021c1d68a856ccdf390c45d30a100bb4946254d4fbdbe36559f7eed0,376,64,329,1,770,Wheeler999416fc021c1d68a856ccdf390c45d30a100bb4946254d4fbdbe36559f7eed0
White,999416fc021c1d68a856ccdf390c45d30a100bb4946254d4fbdbe36559f7eed0,1794,196,2361,3,4354,White999416fc021c1d68a856ccdf390c45d30a100bb4946254d4fbdbe36559f7eed0
Whitfield,999416fc021c1d68a856ccdf390c45d30a100bb4946254d4fbdbe36559f7eed0,5532,374,4468,12,10386,Whitfield999416fc021c1d68a856ccdf390c45d30a100bb4946254d4fbdbe36559f7eed0
Wilcox,999416fc021c1d68a856ccdf390c45d30a100bb4946254d4fbdbe36559f7eed0,611,74,438,0,1123,Wilcox999416fc021c1d68a856ccdf390c45d30a100bb4946254d4fbdbe36559f7eed0
Wilkes,999416fc021c1d68a856ccdf390c45d30a100bb4946254d4fbdbe36559f7eed0,841,71,794,2,1708,Wilkes999416fc021c1d68a856ccdf390c45d30a100bb4946254d4fbdbe36559f7eed0
Wilkinson,999416fc021c1d68a856ccdf390c45d30a100bb4946254d4fbdbe36559f7eed0,1084,72,657,2,1815,Wilkinson999416fc021c1d68a856ccdf390c45d30a100bb4946254d4fbdbe36559f7eed0
Worth,999416fc021c1d68a856ccdf390c45d30a100bb4946254d4fbdbe36559f7eed0,1607,93,1103,2,2805,Worth999416fc021c1d68a856ccdf390c45d30a100bb4946254d4fbdbe36559f7eed0
Appling,665e0a0d3d2f0a7793a079cd76a15edf55a22ee7cd8ff0e6c9ebfeab18f6162b,2554,415,1983,2,4954,Appling665e0a0d3d2f0a7793a079cd76a15edf55a22ee7cd8ff0e6c9ebfeab18f6162b
Atkinson,665e0a0d3d2f0a7793a079cd76a15edf55a22ee7cd8ff0e6c9ebfeab18f6162b,820,65,804,1,1690,Atkinson665e0a0d3d2f0a7793a079cd76a15edf55a22ee7cd8ff0e6c9ebfeab18f6162b
Bacon,665e0a0d3d2f0a7793a079cd76a15edf55a22ee7cd8ff0e6c9ebfeab18f6162b,944,130,1635,3,2712,Bacon665e0a0d3d2f0a7793a079cd76a15edf55a22ee7cd8ff0e6c9ebfeab18f6162b
Baker,665e0a0d3d2f0a7793a079cd76a15edf55a22ee7cd8ff0e6c9ebfeab18f6162b,476,110,390,1,977,Baker665e0a0d3d2f0a7793a079cd76a15edf55a22ee7cd8ff0e6c9ebfeab18f6162b
Baldwin,665e0a0d3d2f0a7793a079cd76a15edf55a22ee7cd8ff0e6c9ebfeab18f6162b,4652,914,6687,6,12259,Baldwin665e0a0d3d2f0a7793a079cd76a15edf55a22ee7cd8ff0e6c9ebfeab18f6162b
Banks,665e0a0d3d2f0a7793a079cd76a15edf55a22ee7cd8ff0e6c9ebfeab18f6162b,2702,203,2489,1,5395,Banks665e0a0d3d2f0a7793a079cd76a15edf55a22ee7cd8ff0e6c9ebfeab18f6162b
Barrow,665e0a0d3d2f0a7793a079cd76a15edf55a22ee7cd8ff0e6c9ebfeab18f6162b,9846,999,12309,1,23155,Barrow665e0a0d3d2f0a7793a079cd76a15edf55a22ee7cd8ff0e6c9ebfeab18f6162b
Bartow,665e0a0d3d2f0a7793a079cd76a15edf55a22ee7cd8ff0e6c9ebfeab18f6162b,15520,1248,13492,22,30282,Bartow665e0a0d3d2f0a7793a079cd76a15edf55a22ee7cd8ff0e6c9ebfeab18f6162b
Ben Hill,665e0a0d3d2f0a7793a079cd76a15edf55a22ee7cd8ff0e6c9ebfeab18f6162b,1155,200,2909,6,4270,Ben Hill665e0a0d3d2f0a7793a079cd76a15edf55a22ee7cd8ff0e6c9ebfeab18f6162b
Berrien,665e0a0d3d2f0a7793a079cd76a15edf55a22ee7cd8ff0e6c9ebfeab18f6162b,2140,309,2426,18,4893,Berrien665e0a0d3d2f0a7793a079cd76a15edf55a22ee7cd8ff0e6c9ebfeab18f6162b
Bibb,665e0a0d3d2f0a7793a079cd76a15edf55a22ee7cd8ff0e6c9ebfeab18f6162b,22907,3075,22636,149,48767,Bibb665e0a0d3d2f0a7793a079cd76a15edf55a22ee7cd8ff0e6c9ebfeab18f6162b
Bleckley,665e0a0d3d2f0a7793a079cd76a15edf55a22ee7cd8ff0e6c9ebfeab18f6162b,1593,200,2084,2,3879,Bleckley665e0a0d3d2f0a7793a079cd76a15edf55a22ee7cd8ff0e6c9ebfeab18f6162b
Brantley,665e0a0d3d2f0a7793a079cd76a15edf55a22ee7cd8ff0e6c9ebfeab18f6162b,1985,186,2137,6,4314,Brantley665e0a0d3d2f0a7793a079cd76a15edf55a22ee7cd8ff0e6c9ebfeab18f6162b
Brooks,665e0a0d3d2f0a7793a079cd76a15edf55a22ee7cd8ff0e6c9ebfeab18f6162b,2075,439,2085,33,4632,Brooks665e0a0d3d2f0a7793a079cd76a15edf55a22ee7cd8ff0e6c9ebfeab18f6162b
Bryan,665e0a0d3d2f0a7793a079cd76a15edf55a22ee7cd8ff0e6c9ebfeab18f6162b,4479,453,7076,8,12016,Bryan665e0a0d3d2f0a7793a079cd76a15edf55a22ee7cd8ff0e6c9ebfeab18f6162b
Bulloch,665e0a0d3d2f0a7793a079cd76a15edf55a22ee7cd8ff0e6c9ebfeab18f6162b,9106,853,9737,42,19738,Bulloch665e0a0d3d2f0a7793a079cd76a15edf55a22ee7cd8ff0e6c9ebfeab18f6162b
Burke,665e0a0d3d2f0a7793a079cd76a15edf55a22ee7cd8ff0e6c9ebfeab18f6162b,3456,760,2673,0,6889,Burke665e0a0d3d2f0a7793a079cd76a15edf55a22ee7cd8ff0e6c9ebfeab18f6162b
Butts,665e0a0d3d2f0a7793a079cd76a15edf55a22ee7cd8ff0e6c9ebfeab18f6162b,2064,236,5053,0,7353,Butts665e0a0d3d2f0a7793a079cd76a15edf55a22ee7cd8ff0e6c9ebfeab18f6162b
Calhoun,665e0a0d3d2f0a7793a079cd76a15edf55a22ee7cd8ff0e6c9ebfeab18f6162b,782,114,474,0,1370,Calhoun665e0a0d3d2f0a7793a079cd76a15edf55a22ee7cd8ff0e6c9ebfeab18f6162b
Camden,665e0a0d3d2f0a7793a079cd76a15edf55a22ee7cd8ff0e6c9ebfeab18f6162b,5565,901,7945,14,14425,Camden665e0a0d3d2f0a7793a079cd76a15edf55a22ee7cd8ff0e6c9ebfeab18f6162b
Candler,665e0a0d3d2f0a7793a079cd76a15edf55a22ee7cd8ff0e6c9ebfeab18f6162b,733,106,1942,5,2786,Candler665e0a0d3d2f0a7793a079cd76a15edf55a22ee7cd8ff0e6c9ebfeab18f6162b
Carroll,665e0a0d3d2f0a7793a079cd76a15edf55a22ee7cd8ff0e6c9ebfeab18f6162b,14361,1237,18308,64,33970,Carroll665e0a0d3d2f0a7793a079cd76a15edf55a22ee7cd8ff0e6c9ebfeab18f6162b
Catoosa,665e0a0d3d2f0a7793a079cd76a15edf55a22ee7cd8ff0e6c9ebfeab18f6162b,6957,562,13119,12,20650,Catoosa665e0a0d3d2f0a7793a079cd76a15edf55a22ee7cd8ff0e6c9ebfeab18f6162b
Charlton,665e0a0d3d2f0a7793a079cd76a15edf55a22ee7cd8ff0e6c9ebfeab18f6162b,1078,157,1476,4,2715,Charlton665e0a0d3d2f0a7793a079cd76a15edf55a22ee7cd8ff0e6c9ebfeab18f6162b
Chatham,665e0a0d3d2f0a7793a079cd76a15edf55a22ee7cd8ff0e6c9ebfeab18f6162b,55045,4166,27518,84,86813,Chatham665e0a0d3d2f0a7793a079cd76a15edf55a22ee7cd8ff0e6c9ebfeab18f6162b
Chattahoochee,665e0a0d3d2f0a7793a079cd76a15edf55a22ee7cd8ff0e6c9ebfeab18f6162b,506,40,433,5,984,Chattahoochee665e0a0d3d2f0a7793a079cd76a15edf55a22ee7cd8ff0e6c9ebfeab18f6162b
Chattooga,665e0a0d3d2f0a7793a079cd76a15edf55a22ee7cd8ff0e6c9ebfeab18f6162b,2908,186,3269,3,6366,Chattooga665e0a0d3d2f0a7793a079cd76a15edf55a22ee7cd8ff0e6c9ebfeab18f6162b
Cherokee,665e0a0d3d2f0a7793a079cd76a15edf55a22ee7cd8ff0e6c9ebfeab18f6162b,35730,4409,49579,22,89740,Cherokee665e0a0d3d2f0a7793a079cd76a15edf55a22ee7cd8ff0e6c9ebfeab18f6162b
Clarke,665e0a0d3d2f0a7793a079cd76a15edf55a22ee7cd8ff0e6c9ebfeab18f6162b,14415,2136,17786,57,34394,Clarke665e0a0d3d2f0a7793a079cd76a15edf55a22ee7cd8ff0e6c9ebfeab18f6162b
Clay,665e0a0d3d2f0a7793a079cd76a15edf55a22ee7cd8ff0e6c9ebfeab18f6162b,366,81,463,2,912,Clay665e0a0d3d2f0a7793a079cd76a15edf55a22ee7cd8ff0e6c9ebfeab18f6162b
Clayton,665e0a0d3d2f0a7793a079cd76a15edf55a22ee7cd8ff0e6c9ebfeab18f6162b,26514,2604,45427,104,74649,Clayton665e0a0d3d2f0a7793a079cd76a15edf55a22ee7cd8ff0e6c9ebfeab18f6162b
Clinch,665e0a0d3d2f0a7793a079cd76a15edf55a22ee7cd8ff0e6c9ebfeab18f6162b,692,67,964,3,1726,Clinch665e0a0d3d2f0a7793a079cd76a15edf55a22ee7cd8ff0e6c9ebfeab18f6162b
Cobb,665e0a0d3d2f0a7793a079cd76a15edf55a22ee7cd8ff0e6c9ebfeab18f6162b,130904,19359,113730,545,264538,Cobb665e0a0d3d2f0a7793a079cd76a15edf55a22ee7cd8ff0e6c9ebfeab18f6162b
Coffee,665e0a0d3d2f0a7793a079cd76a15edf55a22ee7cd8ff0e6c9ebfeab18f6162b,3306,381,6187,0,9874,Coffee665e0a0d3d2f0a7793a079cd76a15edf55a22ee7cd8ff0e6c9ebfeab18f6162b
Colquitt,665e0a0d3d2f0a7793a079cd76a15edf55a22ee7cd8ff0e6c9ebfeab18f6162b,4944,374,4740,4,10062,Colquitt665e0a0d3d2f0a7793a079cd76a15edf55a22ee7cd8ff0e6c9ebfeab18f6162b
Columbia,665e0a0d3d2f0a7793a079cd76a15edf55a22ee7cd8ff0e6c9ebfeab18f6162b,20605,2733,28452,27,51817,Columbia665e0a0d3d2f0a7793a079cd76a15edf55a22ee7cd8ff0e6c9ebfeab18f6162b
Cook,665e0a0d3d2f0a7793a079cd76a15edf55a22ee7cd8ff0e6c9ebfeab18f6162b,1863,184,2529,0,4576,Cook665e0a0d3d2f0a7793a079cd76a15edf55a22ee7cd8ff0e6c9ebfeab18f6162b
Coweta,665e0a0d3d2f0a7793a079cd76a15edf55a22ee7cd8ff0e6c9ebfeab18f6162b,21149,2423,24494,17,48083,Coweta665e0a0d3d2f0a7793a079cd76a15edf55a22ee7cd8ff0e6c9ebfeab18f6162b
Crawford,665e0a0d3d2f0a7793a079cd76a15edf55a22ee7cd8ff0e6c9ebfeab18f6162b,1644,212,1863,4,3723,Crawford665e0a0d3d2f0a7793a079cd76a15edf55a22ee7cd8ff0e6c9ebfeab18f6162b
Crisp,665e0a0d3d2f0a7793a079cd76a15edf55a22ee7cd8ff0e6c9ebfeab18f6162b,1868,272,3614,7,5761,Crisp665e0a0d3d2f0a7793a079cd76a15edf55a22ee7cd8ff0e6c9ebfeab18f6162b
Dade,665e0a0d3d2f0a7793a079cd76a15edf55a22ee7cd8ff0e6c9ebfeab18f6162b,2377,134,2186,0,4697,Dade665e0a0d3d2f0a7793a079cd76a15edf55a22ee7cd8ff0e6c9ebfeab18f6162b
Dawson,665e0a0d3d2f0a7793a079cd76a15edf55a22ee7cd8ff0e6c9ebfeab18f6162b,2371,438,6476,15,9300,Dawson665e0a0d3d2f0a7793a079cd76a15edf55a22ee7cd8ff0e6c9ebfeab18f6162b
Decatur,665e0a0d3d2f0a7793a079cd76a15edf55a22ee7cd8ff0e6c9ebfeab18f6162b,2767,397,3926,20,7110,Decatur665e0a0d3d2f0a7793a079cd76a15edf55a22ee7cd8ff0e6c9ebfeab18f6162b
DeKalb,665e0a0d3d2f0a7793a079cd76a15edf55a22ee7cd8ff0e6c9ebfeab18f6162b,94480,12886,146176,347,253889,DeKalb665e0a0d3d2f0a7793a079cd76a15edf55a22ee7cd8ff0e6c9ebfeab18f6162b
Dodge,665e0a0d3d2f0a7793a079cd76a15edf55a22ee7cd8ff0e6c9ebfeab18f6162b,2538,272,1991,0,4801,Dodge665e0a0d3d2f0a7793a079cd76a15edf55a22ee7cd8ff0e6c9ebfeab18f6162b
Dooly,665e0a0d3d2f0a7793a079cd76a15edf55a22ee7cd8ff0e6c9ebfeab18f6162b,1248,147,1290,11,2696,Dooly665e0a0d3d2f0a7793a079cd76a15edf55a22ee7cd8ff0e6c9ebfeab18f6162b
Dougherty,665e0a0d3d2f0a7793a079cd76a15edf55a22ee7cd8ff0e6c9ebfeab18f6162b,13548,1295,11246,53,26142,Dougherty665e0a0d3d2f0a7793a079cd76a15edf55a22ee7cd8ff0e6c9ebfeab18f6162b
Douglas,665e0a0d3d2f0a7793a079cd76a15edf55a22ee7cd8ff0e6c9ebfeab18f6162b,15096,2033,28635,26,45790,Douglas665e0a0d3d2f0a7793a079cd76a15edf55a22ee7cd8ff0e6c9ebfeab18f6162b
Early,665e0a0d3d2f0a7793a079cd76a15edf55a22ee7cd8ff0e6c9ebfeab18f6162b,1513,283,1541,0,3337,Early665e0a0d3d2f0a7793a079cd76a15edf55a22ee7cd8ff0e6c9ebfeab18f6162b
Echols,665e0a0d3d2f0a7793a079cd76a15edf55a22ee7cd8ff0e6c9ebfeab18f6162b,337,31,473,0,841,Echols665e0a0d3d2f0a7793a079cd76a15edf55a22ee7cd8ff0e6c9ebfeab18f6162b
Effingham,665e0a0d3d2f0a7793a079cd76a15edf55a22ee7cd8ff0e6c9ebfeab18f6162b,8552,557,9543,4,18656,Effingham665e0a0d3d2f0a7793a079cd76a15edf55a22ee7cd8ff0e6c9ebfeab18f6162b
Elbert,665e0a0d3d2f0a7793a079cd76a15edf55a22ee7cd8ff0e6c9ebfeab18f6162b,2073,395,3339,46,5853,Elbert665e0a0d3d2f0a7793a079cd76a15edf55a22ee7cd8ff0e6c9ebfeab18f6162b
Emanuel,665e0a0d3d2f0a7793a079cd76a15edf55a22ee7cd8ff0e6c9ebfeab18f6162b,2950,253,2408,7,5618,Emanuel665e0a0d3d2f0a7793a079cd76a15edf55a22ee7cd8ff0e6c9ebfeab18f6162b
Evans,665e0a0d3d2f0a7793a079cd76a15edf55a22ee7cd8ff0e6c9ebfeab18f6162b,813,142,1610,0,2565,Evans665e0a0d3d2f0a7793a079cd76a15edf55a22ee7cd8ff0e6c9ebfeab18f6162b
Fannin,665e0a0d3d2f0a7793a079cd76a15edf55a22ee7cd8ff0e6c9ebfeab18f6162b,3733,635,4530,6,8904,Fannin665e0a0d3d2f0a7793a079cd76a15edf55a22ee7cd8ff0e6c9ebfeab18f6162b
Fayette,665e0a0d3d2f0a7793a079cd76a15edf55a22ee7cd8ff0e6c9ebfeab18f6162b,14196,2400,30732,17,47345,Fayette665e0a0d3d2f0a7793a079cd76a15edf55a22ee7cd8ff0e6c9ebfeab18f6162b
Floyd,665e0a0d3d2f0a7793a079cd76a15edf55a22ee7cd8ff0e6c9ebfeab18f6162b,10907,1118,14813,82,26920,Floyd665e0a0d3d2f0a7793a079cd76a15edf55a22ee7cd8ff0e6c9ebfeab18f6162b
Forsyth,665e0a0d3d2f0a7793a079cd76a15edf55a22ee7cd8ff0e6c9ebfeab18f6162b,20275,3306,55221,31,78833,Forsyth665e0a0d3d2f0a7793a079cd76a15edf55a22ee7cd8ff0e6c9ebfeab18f6162b
Franklin,665e0a0d3d2f0a7793a079cd76a15edf55a22ee7cd8ff0e6c9ebfeab18f6162b,3183,335,3054,0,6572,Franklin665e0a0d3d2f0a7793a079cd76a15edf55a22ee7cd8ff0e6c9ebfeab18f6162b
Fulton,665e0a0d3d2f0a7793a079cd76a15edf55a22ee7cd8ff0e6c9ebfeab18f6162b,119085,17071,207020,825,344001,Fulton665e0a0d3d2f0a7793a079cd76a15edf55a22ee7cd8ff0e6c9ebfeab18f6162b
Gilmer,665e0a0d3d2f0a7793a079cd76a15edf55a22ee7cd8ff0e6c9ebfeab18f6162b,3642,555,4970,8,9175,Gilmer665e0a0d3d2f0a7793a079cd76a15edf55a22ee7cd8ff0e6c9ebfeab18f6162b
Glascock,665e0a0d3d2f0a7793a079cd76a15edf55a22ee7cd8ff0e6c9ebfeab18f6162b,453,57,510,0,1020,Glascock665e0a0d3d2f0a7793a079cd76a15edf55a22ee7cd8ff0e6c9ebfeab18f6162b
Glynn,665e0a0d3d2f0a7793a079cd76a15edf55a22ee7cd8ff0e6c9ebfeab18f6162b,10431,1277,13832,42,25582,Glynn665e0a0d3d2f0a7793a079cd76a15edf55a22ee7cd8ff0e6c9ebfeab18f6162b
Gordon,665e0a0d3d2f0a7793a079cd76a15edf55a22ee7cd8ff0e6c9ebfeab18f6162b,6435,479,7044,18,13976,Gordon665e0a0d3d2f0a7793a079cd76a15edf55a22ee7cd8ff0e6c9ebfeab18f6162b
Grady,665e0a0d3d2f0a7793a079cd76a15edf55a22ee7cd8ff0e6c9ebfeab18f6162b,2708,216,3544,7,6475,Grady665e0a0d3d2f0a7793a079cd76a15edf55a22ee7cd8ff0e6c9ebfeab18f6162b
Greene,665e0a0d3d2f0a7793a079cd76a15edf55a22ee7cd8ff0e6c9ebfeab18f6162b,1969,501,4324,4,6798,Greene665e0a0d3d2f0a7793a079cd76a15edf55a22ee7cd8ff0e6c9ebfeab18f6162b
Gwinnett,665e0a0d3d2f0a7793a079cd76a15edf55a22ee7cd8ff0e6c9ebfeab18f6162b,125225,15611,121684,1078,263598,Gwinnett665e0a0d3d2f0a7793a079cd76a15edf55a22ee7cd8ff0e6c9ebfeab18f6162b
Habersham,665e0a0d3d2f0a7793a079cd76a15edf55a22ee7cd8ff0e6c9ebfeab18f6162b,2659,787,9274,1,12721,Habersham665e0a0d3d2f0a7793a079cd76a15edf55a22ee7cd8ff0e6c9ebfeab18f6162b
Hall,665e0a0d3d2f0a7793a079cd76a15edf55a22ee7cd8ff0e6c9ebfeab18f6162b,24885,2949,27437,50,55321,Hall665e0a0d3d2f0a7793a079cd76a15edf55a22ee7cd8ff0e6c9ebfeab18f6162b
Hancock,665e0a0d3d2f0a7793a079cd76a15edf55a22ee7cd8ff0e6c9ebfeab18f6162b,1118,266,982,6,2372,Hancock665e0a0d3d2f0a7793a079cd76a15edf55a22ee7cd8ff0e6c9ebfeab18f6162b
Haralson,665e0a0d3d2f0a7793a079cd76a15edf55a22ee7cd8ff0e6c9ebfeab18f6162b,4197,379,3956,5,8537,Haralson665e0a0d3d2f0a7793a079cd76a15edf55a22ee7cd8ff0e6c9ebfeab18f6162b
Harris,665e0a0d3d2f0a7793a079cd76a15edf55a22ee7cd8ff0e6c9ebfeab18f6162b,5366,609,6983,1,12959,Harris665e0a0d3d2f0a7793a079cd76a15edf55a22ee7cd8ff0e6c9ebfeab18f6162b
Hart,665e0a0d3d2f0a7793a079cd76a15edf55a22ee7cd8ff0e6c9ebfeab18f6162b,3059,367,3842,1,7269,Hart665e0a0d3d2f0a7793a079cd76a15edf55a22ee7cd8ff0e6c9ebfeab18f6162b
Heard,665e0a0d3d2f0a7793a079cd76a15edf55a22ee7cd8ff0e6c9ebfeab18f6162b,1674,226,1240,2,3142,Heard665e0a0d3d2f0a7793a079cd76a15edf55a22ee7cd8ff0e6c9ebfeab18f6162b
Henry,665e0a0d3d2f0a7793a079cd76a15edf55a22ee7cd8ff0e6c9ebfeab18f6162b,20789,2987,54586,148,78510,Henry665e0a0d3d2f0a7793a079cd76a15edf55a22ee7cd8ff0e6c9ebfeab18f6162b
Houston,665e0a0d3d2f0a7793a079cd76a15edf55a22ee7cd8ff0e6c9ebfeab18f6162b,14650,2156,30169,95,47070,Houston665e0a0d3d2f0a7793a079cd76a15edf55a22ee7cd8ff0e6c9ebfeab18f6162b
Irwin,665e0a0d3d2f0a7793a079cd76a15edf55a22ee7cd8ff0e6c9ebfeab18f6162b,1162,100,1331,5,2598,Irwin665e0a0d3d2f0a7793a079cd76a15edf55a22ee7cd8ff0e6c9ebfeab18f6162b
Jackson,665e0a0d3d2f0a7793a079cd76a15edf55a22ee7cd8ff0e6c9ebfeab18f6162b,7661,675,12982,36,21354,Jackson665e0a0d3d2f0a7793a079cd76a15edf55a22ee7cd8ff0e6c9ebfeab18f6162b
Jasper,665e0a0d3d2f0a7793a079cd76a15edf55a22ee7cd8ff0e6c9ebfeab18f6162b,1792,331,2592,5,4720,Jasper665e0a0d3d2f0a7793a079cd76a15edf55a22ee7cd8ff0e6c9ebfeab18f6162b
Jeff Davis,665e0a0d3d2f0a7793a079cd76a15edf55a22ee7cd8ff0e6c9ebfeab18f6162b,1595,151,1865,2,3613,Jeff Davis665e0a0d3d2f0a7793a079cd76a15edf55a22ee7cd8ff0e6c9ebfeab18f6162b
Jefferson,665e0a0d3d2f0a7793a079cd76a15edf55a22ee7cd8ff0e6c9ebfeab18f6162b,2327,353,1912,12,4604,Jefferson665e0a0d3d2f0a7793a079cd76a15edf55a22ee7cd8ff0e6c9ebfeab18f6162b
Jenkins,665e0a0d3d2f0a7793a079cd76a15edf55a22ee7cd8ff0e6c9ebfeab18f6162b,861,130,1089,14,2094,Jenkins665e0a0d3d2f0a7793a079cd76a15edf55a22ee7cd8ff0e6c9ebfeab18f6162b
Johnson,665e0a0d3d2f0a7793a079cd76a15edf55a22ee7cd8ff0e6c9ebfeab18f6162b,987,174,1254,0,2415,Johnson665e0a0d3d2f0a7793a079cd76a15edf55a22ee7cd8ff0e6c9ebfeab18f6162b
Jones,665e0a0d3d2f0a7793a079cd76a15edf55a22ee7cd8ff0e6c9ebfeab18f6162b,3449,637,5421,1,9508,Jones665e0a0d3d2f0a7793a079cd76a15edf55a22ee7cd8ff0e6c9ebfeab18f6162b
Lamar,665e0a0d3d2f0a7793a079cd76a15edf55a22ee7cd8ff0e6c9ebfeab18f6162b,2181,278,3202,6,5667,Lamar665e0a0d3d2f0a7793a079cd76a15edf55a22ee7cd8ff0e6c9ebfeab18f6162b
Lanier,665e0a0d3d2f0a7793a079cd76a15edf55a22ee7cd8ff0e6c9ebfeab18f6162b,834,59,1205,0,2098,Lanier665e0a0d3d2f0a7793a079cd76a15edf55a22ee7cd8ff0e6c9ebfeab18f6162b
Laurens,665e0a0d3d2f0a7793a079cd76a15edf55a22ee7cd8ff0e6c9ebfeab18f6162b,6975,896,6109,2,13982,Laurens665e0a0d3d2f0a7793a079cd76a15edf55a22ee7cd8ff0e6c9ebfeab18f6162b
Lee,665e0a0d3d2f0a7793a079cd76a15edf55a22ee7cd8ff0e6c9ebfeab18f6162b,5249,416,5725,4,11394,Lee665e0a0d3d2f0a7793a079cd76a15edf55a22ee7cd8ff0e6c9ebfeab18f6162b
Liberty,665e0a0d3d2f0a7793a079cd76a15edf55a22ee7cd8ff0e6c9ebfeab18f6162b,4956,482,7183,21,12642,Liberty665e0a0d3d2f0a7793a079cd76a15edf55a22ee7cd8ff0e6c9ebfeab18f6162b
Lincoln,665e0a0d3d2f0a7793a079cd76a15edf55a22ee7cd8ff0e6c9ebfeab18f6162b,1146,303,1535,1,2985,Lincoln665e0a0d3d2f0a7793a079cd76a15edf55a22ee7cd8ff0e6c9ebfeab18f6162b
Long,665e0a0d3d2f0a7793a079cd76a15edf55a22ee7cd8ff0e6c9ebfeab18f6162b,1541,78,1549,4,3172,Long665e0a0d3d2f0a7793a079cd76a15edf55a22ee7cd8ff0e6c9ebfeab18f6162b
Lowndes,665e0a0d3d2f0a7793a079cd76a15edf55a22ee7cd8ff0e6c9ebfeab18f6162b,8556,1286,18706,387,28935,Lowndes665e0a0d3d2f0a7793a079cd76a15edf55a22ee7cd8ff0e6c9ebfeab18f6162b
Lumpkin,665e0a0d3d2f0a7793a079cd76a15edf55a22ee7cd8ff0e6c9ebfeab18f6162b,2246,446,6835,4,9531,Lumpkin665e0a0d3d2f0a7793a079cd76a15edf55a22ee7cd8ff0e6c9ebfeab18f6162b
Macon,665e0a0d3d2f0a7793a079cd76a15edf55a22ee7cd8ff0e6c9ebfeab18f6162b,1276,187,1488,0,2951,Macon665e0a0d3d2f0a7793a079cd76a15edf55a22ee7cd8ff0e6c9ebfeab18f6162b
Madison,665e0a0d3d2f0a7793a079cd76a15edf55a22ee7cd8ff0e6c9ebfeab18f6162b,3969,390,4547,6,8912,Madison665e0a0d3d2f0a7793a079cd76a15edf55a22ee7cd8ff0e6c9ebfeab18f6162b
Marion,665e0a0d3d2f0a7793a079cd76a15edf55a22ee7cd8ff0e6c9ebfeab18f6162b,1179,199,941,0,2319,Marion665e0a0d3d2f0a7793a079cd76a15edf55a22ee7cd8ff0e6c9ebfeab18f6162b
McDuffie,665e0a0d3d2f0a7793a079cd76a15edf55a22ee7cd8ff0e6c9ebfeab18f6162b,2511,441,4008,0,6960,McDuffie665e0a0d3d2f0a7793a079cd76a15edf55a22ee7cd8ff0e6c9ebfeab18f6162b
McIntosh,665e0a0d3d2f0a7793a079cd76a15edf55a22ee7cd8ff0e6c9ebfeab18f6162b,1556,434,2121,9,4120,McIntosh665e0a0d3d2f0a7793a079cd76a15edf55a22ee7cd8ff0e6c9ebfeab18f6162b
Meriwether,665e0a0d3d2f0a7793a079cd76a15edf55a22ee7cd8ff0e6c9ebfeab18f6162b,3842,323,2555,3,6723,Meriwether665e0a0d3d2f0a7793a079cd76a15edf55a22ee7cd8ff0e6c9ebfeab18f6162b
Miller,665e0a0d3d2f0a7793a079cd76a15edf55a22ee7cd8ff0e6c9ebfeab18f6162b,744,113,822,2,1681,Miller665e0a0d3d2f0a7793a079cd76a15edf55a22ee7cd8ff0e6c9ebfeab18f6162b
Mitchell,665e0a0d3d2f0a7793a079cd76a15edf55a22ee7cd8ff0e6c9ebfeab18f6162b,2567,405,2843,8,5823,Mitchell665e0a0d3d2f0a7793a079cd76a15edf55a22ee7cd8ff0e6c9ebfeab18f6162b
Monroe,665e0a0d3d2f0a7793a079cd76a15edf55a22ee7cd8ff0e6c9ebfeab18f6162b,4313,455,4884,7,9659,Monroe665e0a0d3d2f0a7793a079cd76a15edf55a22ee7cd8ff0e6c9ebfeab18f6162b
Montgomery,665e0a0d3d2f0a7793a079cd76a15edf55a22ee7cd8ff0e6c9ebfeab18f6162b,1485,97,912,0,2494,Montgomery665e0a0d3d2f0a7793a079cd76a15edf55a22ee7cd8ff0e6c9ebfeab18f6162b
Morgan,665e0a0d3d2f0a7793a079cd76a15edf55a22ee7cd8ff0e6c9ebfeab18f6162b,2664,293,4162,3,7122,Morgan665e0a0d3d2f0a7793a079cd76a15edf55a22ee7cd8ff0e6c9ebfeab18f6162b
Murray,665e0a0d3d2f0a7793a079cd76a15edf55a22ee7cd8ff0e6c9ebfeab18f6162b,4769,301,4178,0,9248,Murray665e0a0d3d2f0a7793a079cd76a15edf55a22ee7cd8ff0e6c9ebfeab18f6162b
Muscogee,665e0a0d3d2f0a7793a079cd76a15edf55a22ee7cd8ff0e6c9ebfeab18f6162b,23253,3130,25818,84,52285,Muscogee665e0a0d3d2f0a7793a079cd76a15edf55a22ee7cd8ff0e6c9ebfeab18f6162b
Newton,665e0a0d3d2f0a7793a079cd76a15edf55a22ee7cd8ff0e6c9ebfeab18f6162b,15738,1688,17682,4,35112,Newton665e0a0d3d2f0a7793a079cd76a15edf55a22ee7cd8ff0e6c9ebfeab18f6162b
Oconee,665e0a0d3d2f0a7793a079cd76a15edf55a22ee7cd8ff0e6c9ebfeab18f6162b,5850,722,9062,7,15641,Oconee665e0a0d3d2f0a7793a079cd76a15edf55a22ee7cd8ff0e6c9ebfeab18f6162b
Oglethorpe,665e0a0d3d2f0a7793a079cd76a15edf55a22ee7cd8ff0e6c9ebfeab18f6162b,1785,294,3005,2,5086,Oglethorpe665e0a0d3d2f0a7793a079cd76a15edf55a22ee7cd8ff0e6c9ebfeab18f6162b
Paulding,665e0a0d3d2f0a7793a079cd76a15edf55a22ee7cd8ff0e6c9ebfeab18f6162b,14943,2574,34301,20,51838,Paulding665e0a0d3d2f0a7793a079cd76a15edf55a22ee7cd8ff0e6c9ebfeab18f6162b
Peach,665e0a0d3d2f0a7793a079cd76a15edf55a22ee7cd8ff0e6c9ebfeab18f6162b,2420,292,5269,21,8002,Peach665e0a0d3d2f0a7793a079cd76a15edf55a22ee7cd8ff0e6c9ebfeab18f6162b
Pickens,665e0a0d3d2f0a7793a079cd76a15edf55a22ee7cd8ff0e6c9ebfeab18f6162b,4039,228,6286,1,10554,Pickens665e0a0d3d2f0a7793a079cd76a15edf55a22ee7cd8ff0e6c9ebfeab18f6162b
Pierce,665e0a0d3d2f0a7793a079cd76a15edf55a22ee7cd8ff0e6c9ebfeab18f6162b,1438,288,3441,1,5168,Pierce665e0a0d3d2f0a7793a079cd76a15edf55a22ee7cd8ff0e6c9ebfeab18f6162b
Pike,665e0a0d3d2f0a7793a079cd76a15edf55a22ee7cd8ff0e6c9ebfeab18f6162b,2406,305,3774,4,6489,Pike665e0a0d3d2f0a7793a079cd76a15edf55a22ee7cd8ff0e6c9ebfeab18f6162b
Polk,665e0a0d3d2f0a7793a079cd76a15edf55a22ee7cd8ff0e6c9ebfeab18f6162b,3410,395,7016,3,10824,Polk665e0a0d3d2f0a7793a079cd76a15edf55a22ee7cd8ff0e6c9ebfeab18f6162b
Pulaski,665e0a0d3d2f0a7793a079cd76a15edf55a22ee7cd8ff0e6c9ebfeab18f6162b,625,152,1746,1,2524,Pulaski665e0a0d3d2f0a7793a079cd76a15edf55a22ee7cd8ff0e6c9ebfeab18f6162b
Putnam,665e0a0d3d2f0a7793a079cd76a15edf55a22ee7cd8ff0e6c9ebfeab18f6162b,2600,453,3982,4,7039,Putnam665e0a0d3d2f0a7793a079cd76a15edf55a22ee7cd8ff0e6c9ebfeab18f6162b
Quitman,665e0a0d3d2f0a7793a079cd76a15edf55a22ee7cd8ff0e6c9ebfeab18f6162b,330,45,369,0,744,Quitman665e0a0d3d2f0a7793a079cd76a15edf55a22ee7cd8ff0e6c9ebfeab18f6162b
Rabun,665e0a0d3d2f0a7793a079cd76a15edf55a22ee7cd8ff0e6c9ebfeab18f6162b,1100,739,4377,0,6216,Rabun665e0a0d3d2f0a7793a079cd76a15edf55a22ee7cd8ff0e6c9ebfeab18f6162b
Randolph,665e0a0d3d2f0a7793a079cd76a15edf55a22ee7cd8ff0e6c9ebfeab18f6162b,1027,124,934,1,2086,Randolph665e0a0d3d2f0a7793a079cd76a15edf55a22ee7cd8ff0e6c9ebfeab18f6162b
Richmond,665e0a0d3d2f0a7793a079cd76a15edf55a22ee7cd8ff0e6c9ebfeab18f6162b,26825,3697,27916,71,58509,Richmond665e0a0d3d2f0a7793a079cd76a15edf55a22ee7cd8ff0e6c9ebfeab18f6162b
Rockdale,665e0a0d3d2f0a7793a079cd76a15edf55a22ee7cd8ff0e6c9ebfeab18f6162b,8032,1227,20526,23,29808,Rockdale665e0a0d3d2f0a7793a079cd76a15edf55a22ee7cd8ff0e6c9ebfeab18f6162b
Schley,665e0a0d3d2f0a7793a079cd76a15edf55a22ee7cd8ff0e6c9ebfeab18f6162b,431,61,891,0,1383,Schley665e0a0d3d2f0a7793a079cd76a15edf55a22ee7cd8ff0e6c9ebfeab18f6162b
Screven,665e0a0d3d2f0a7793a079cd76a15edf55a22ee7cd8ff0e6c9ebfeab18f6162b,1940,140,1851,0,3931,Screven665e0a0d3d2f0a7793a079cd76a15edf55a22ee7cd8ff0e6c9ebfeab18f6162b
Seminole,665e0a0d3d2f0a7793a079cd76a15edf55a22ee7cd8ff0e6c9ebfeab18f6162b,1435,142,1062,2,2641,Seminole665e0a0d3d2f0a7793a079cd76a15edf55a22ee7cd8ff0e6c9ebfeab18f6162b
Spalding,665e0a0d3d2f0a7793a079cd76a15edf55a22ee7cd8ff0e6c9ebfeab18f6162b,7019,889,11043,13,18964,Spalding665e0a0d3d2f0a7793a079cd76a15edf55a22ee7cd8ff0e6c9ebfeab18f6162b
Stephens,665e0a0d3d2f0a7793a079cd76a15edf55a22ee7cd8ff0e6c9ebfeab18f6162b,1594,518,5408,2,7522,Stephens665e0a0d3d2f0a7793a079cd76a15edf55a22ee7cd8ff0e6c9ebfeab18f6162b
Stewart,665e0a0d3d2f0a7793a079cd76a15edf55a22ee7cd8ff0e6c9ebfeab18f6162b,562,223,488,3,1276,Stewart665e0a0d3d2f0a7793a079cd76a15edf55a22ee7cd8ff0e6c9ebfeab18f6162b
Sumter,665e0a0d3d2f0a7793a079cd76a15edf55a22ee7cd8ff0e6c9ebfeab18f6162b,3293,621,4230,1,8145,Sumter665e0a0d3d2f0a7793a079cd76a15edf55a22ee7cd8ff0e6c9ebfeab18f6162b
Talbot,665e0a0d3d2f0a7793a079cd76a15edf55a22ee7cd8ff0e6c9ebfeab18f6162b,1303,376,595,0,2274,Talbot665e0a0d3d2f0a7793a079cd76a15edf55a22ee7cd8ff0e6c9ebfeab18f6162b
Taliaferro,665e0a0d3d2f0a7793a079cd76a15edf55a22ee7cd8ff0e6c9ebfeab18f6162b,250,75,264,1,590,Taliaferro665e0a0d3d2f0a7793a079cd76a15edf55a22ee7cd8ff0e6c9ebfeab18f6162b
Tattnall,665e0a0d3d2f0a7793a079cd76a15edf55a22ee7cd8ff0e6c9ebfeab18f6162b,1850,433,2528,5,4816,Tattnall665e0a0d3d2f0a7793a079cd76a15edf55a22ee7cd8ff0e6c9ebfeab18f6162b
Taylor,665e0a0d3d2f0a7793a079cd76a15edf55a22ee7cd8ff0e6c9ebfeab18f6162b,958,230,1310,0,2498,Taylor665e0a0d3d2f0a7793a079cd76a15edf55a22ee7cd8ff0e6c9ebfeab18f6162b
Telfair,665e0a0d3d2f0a7793a079cd76a15edf55a22ee7cd8ff0e6c9ebfeab18f6162b,1322,244,994,1,2561,Telfair665e0a0d3d2f0a7793a079cd76a15edf55a22ee7cd8ff0e6c9ebfeab18f6162b
Terrell,665e0a0d3d2f0a7793a079cd76a15edf55a22ee7cd8ff0e6c9ebfeab18f6162b,1393,219,1406,2,3020,Terrell665e0a0d3d2f0a7793a079cd76a15edf55a22ee7cd8ff0e6c9ebfeab18f6162b
Thomas,665e0a0d3d2f0a7793a079cd76a15edf55a22ee7cd8ff0e6c9ebfeab18f6162b,5157,670,7882,4,13713,Thomas665e0a0d3d2f0a7793a079cd76a15edf55a22ee7cd8ff0e6c9ebfeab18f6162b
Tift,665e0a0d3d2f0a7793a079cd76a15edf55a22ee7cd8ff0e6c9ebfeab18f6162b,4084,439,6233,11,10767,Tift665e0a0d3d2f0a7793a079cd76a15edf55a22ee7cd8ff0e6c9ebfeab18f6162b
Toombs,665e0a0d3d2f0a7793a079cd76a15edf55a22ee7cd8ff0e6c9ebfeab18f6162b,2659,483,3420,1,6563,Toombs665e0a0d3d2f0a7793a079cd76a15edf55a22ee7cd8ff0e6c9ebfeab18f6162b
Towns,665e0a0d3d2f0a7793a079cd76a15edf55a22ee7cd8ff0e6c9ebfeab18f6162b,1359,332,3451,8,5150,Towns665e0a0d3d2f0a7793a079cd76a15edf55a22ee7cd8ff0e6c9ebfeab18f6162b
Treutlen,665e0a0d3d2f0a7793a079cd76a15edf55a22ee7cd8ff0e6c9ebfeab18f6162b,598,126,1031,2,1757,Treutlen665e0a0d3d2f0a7793a079cd76a15edf55a22ee7cd8ff0e6c9ebfeab18f6162b
Troup,665e0a0d3d2f0a7793a079cd76a15edf55a22ee7cd8ff0e6c9ebfeab18f6162b,8614,1004,9511,169,19298,Troup665e0a0d3d2f0a7793a079cd76a15edf55a22ee7cd8ff0e6c9ebfeab18f6162b
Turner,665e0a0d3d2f0a7793a079cd76a15edf55a22ee7cd8ff0e6c9ebfeab18f6162b,823,70,1518,3,2414,Turner665e0a0d3d2f0a7793a079cd76a15edf55a22ee7cd8ff0e6c9ebfeab18f6162b
Twiggs,665e0a0d3d2f0a7793a079cd76a15edf55a22ee7cd8ff0e6c9ebfeab18f6162b,1546,253,1136,0,2935,Twiggs665e0a0d3d2f0a7793a079cd76a15edf55a22ee7cd8ff0e6c9ebfeab18f6162b
Union,665e0a0d3d2f0a7793a079cd76a15edf55a22ee7cd8ff0e6c9ebfeab18f6162b,2908,530,5692,1,9131,Union665e0a0d3d2f0a7793a079cd76a15edf55a22ee7cd8ff0e6c9ebfeab18f6162b
Upson,665e0a0d3d2f0a7793a079cd76a15edf55a22ee7cd8ff0e6c9ebfeab18f6162b,2177,378,5426,5,7986,Upson665e0a0d3d2f0a7793a079cd76a15edf55a22ee7cd8ff0e6c9ebfeab18f6162b
Walker,665e0a0d3d2f0a7793a079cd76a15edf55a22ee7cd8ff0e6c9ebfeab18f6162b,7316,809,10443,9,18577,Walker665e0a0d3d2f0a7793a079cd76a15edf55a22ee7cd8ff0e6c9ebfeab18f6162b
Walton,665e0a0d3d2f0a7793a079cd76a15edf55a22ee7cd8ff0e6c9ebfeab18f6162b,16181,1466,14402,27,32076,Walton665e0a0d3d2f0a7793a079cd76a15edf55a22ee7cd8ff0e6c9ebfeab18f6162b
Ware,665e0a0d3d2f0a7793a079cd76a15edf55a22ee7cd8ff0e6c9ebfeab18f6162b,3457,457,5059,0,8973,Ware665e0a0d3d2f0a7793a079cd76a15edf55a22ee7cd8ff0e6c9ebfeab18f6162b
Warren,665e0a0d3d2f0a7793a079cd76a15edf55a22ee7cd8ff0e6c9ebfeab18f6162b,623,104,783,1,1511,Warren665e0a0d3d2f0a7793a079cd76a15edf55a22ee7cd8ff0e6c9ebfeab18f6162b
Washington,665e0a0d3d2f0a7793a079cd76a15edf55a22ee7cd8ff0e6c9ebfeab18f6162b,2472,544,2801,13,5830,Washington665e0a0d3d2f0a7793a079cd76a15edf55a22ee7cd8ff0e6c9ebfeab18f6162b
Wayne,665e0a0d3d2f0a7793a079cd76a15edf55a22ee7cd8ff0e6c9ebfeab18f6162b,3174,328,4093,7,7602,Wayne665e0a0d3d2f0a7793a079cd76a15edf55a22ee7cd8ff0e6c9ebfeab18f6162b
Webster,665e0a0d3d2f0a7793a079cd76a15edf55a22ee7cd8ff0e6c9ebfeab18f6162b,336,98,355,1,790,Webster665e0a0d3d2f0a7793a079cd76a15edf55a22ee7cd8ff0e6c9ebfeab18f6162b
Wheeler,665e0a0d3d2f0a7793a079cd76a15edf55a22ee7cd8ff0e6c9ebfeab18f6162b,668,109,642,3,1422,Wheeler665e0a0d3d2f0a7793a079cd76a15edf55a22ee7cd8ff0e6c9ebfeab18f6162b
White,665e0a0d3d2f0a7793a079cd76a15edf55a22ee7cd8ff0e6c9ebfeab18f6162b,3765,539,5095,11,9410,White665e0a0d3d2f0a7793a079cd76a15edf55a22ee7cd8ff0e6c9ebfeab18f6162b
Whitfield,665e0a0d3d2f0a7793a079cd76a15edf55a22ee7cd8ff0e6c9ebfeab18f6162b,11528,934,9917,24,22403,Whitfield665e0a0d3d2f0a7793a079cd76a15edf55a22ee7cd8ff0e6c9ebfeab18f6162b
Wilcox,665e0a0d3d2f0a7793a079cd76a15edf55a22ee7cd8ff0e6c9ebfeab18f6162b,1060,159,850,0,2069,Wilcox665e0a0d3d2f0a7793a079cd76a15edf55a22ee7cd8ff0e6c9ebfeab18f6162b
Wilkes,665e0a0d3d2f0a7793a079cd76a15edf55a22ee7cd8ff0e6c9ebfeab18f6162b,1441,144,1431,5,3021,Wilkes665e0a0d3d2f0a7793a079cd76a15edf55a22ee7cd8ff0e6c9ebfeab18f6162b
Wilkinson,665e0a0d3d2f0a7793a079cd76a15edf55a22ee7cd8ff0e6c9ebfeab18f6162b,1790,165,1126,3,3084,Wilkinson665e0a0d3d2f0a7793a079cd76a15edf55a22ee7cd8ff0e6c9ebfeab18f6162b
Worth,665e0a0d3d2f0a7793a079cd76a15edf55a22ee7cd8ff0e6c9ebfeab18f6162b,3208,204,2678,9,6099,Worth665e0a0d3d2f0a7793a079cd76a15edf55a22ee7cd8ff0e6c9ebfeab18f6162b
Appling,3920c9b2662ea352ae32a275bde1e323003357851b8f7bffa23c443a90041fda,867,86,596,0,1549,Appling3920c9b2662ea352ae32a275bde1e323003357851b8f7bffa23c443a90041fda
Atkinson,3920c9b2662ea352ae32a275bde1e323003357851b8f7bffa23c443a90041fda,269,16,346,0,631,Atkinson3920c9b2662ea352ae32a275bde1e323003357851b8f7bffa23c443a90041fda
Bacon,3920c9b2662ea352ae32a275bde1e323003357851b8f7bffa23c443a90041fda,291,25,481,2,799,Bacon3920c9b2662ea352ae32a275bde1e323003357851b8f7bffa23c443a90041fda
Baker,3920c9b2662ea352ae32a275bde1e323003357851b8f7bffa23c443a90041fda,172,27,126,0,325,Baker3920c9b2662ea352ae32a275bde1e323003357851b8f7bffa23c443a90041fda
Baldwin,3920c9b2662ea352ae32a275bde1e323003357851b8f7bffa23c443a90041fda,1289,137,1618,3,3047,Baldwin3920c9b2662ea352ae32a275bde1e323003357851b8f7bffa23c443a90041fda
Banks,3920c9b2662ea352ae32a275bde1e323003357851b8f7bffa23c443a90041fda,725,31,628,0,1384,Banks3920c9b2662ea352ae32a275bde1e323003357851b8f7bffa23c443a90041fda
Barrow,3920c9b2662ea352ae32a275bde1e323003357851b8f7bffa23c443a90041fda,2261,141,2566,0,4968,Barrow3920c9b2662ea352ae32a275bde1e323003357851b8f7bffa23c443a90041fda
Bartow,3920c9b2662ea352ae32a275bde1e323003357851b8f7bffa23c443a90041fda,4248,205,3325,3,7781,Bartow3920c9b2662ea352ae32a275bde1e323003357851b8f7bffa23c443a90041fda
Ben Hill,3920c9b2662ea352ae32a275bde1e323003357851b8f7bffa23c443a90041fda,369,33,954,0,1356,Ben Hill3920c9b2662ea352ae32a275bde1e323003357851b8f7bffa23c443a90041fda
Berrien,3920c9b2662ea352ae32a275bde1e323003357851b8f7bffa23c443a90041fda,634,47,691,0,1372,Berrien3920c9b2662ea352ae32a275bde1e323003357851b8f7bffa23c443a90041fda
Bibb,3920c9b2662ea352ae32a275bde1e323003357851b8f7bffa23c443a90041fda,5952,492,5259,41,11744,Bibb3920c9b2662ea352ae32a275bde1e323003357851b8f7bffa23c443a90041fda
Bleckley,3920c9b2662ea352ae32a275bde1e323003357851b8f7bffa23c443a90041fda,388,33,423,1,845,Bleckley3920c9b2662ea352ae32a275bde1e323003357851b8f7bffa23c443a90041fda
Brantley,3920c9b2662ea352ae32a275bde1e323003357851b8f7bffa23c443a90041fda,634,32,714,0,1380,Brantley3920c9b2662ea352ae32a275bde1e323003357851b8f7bffa23c443a90041fda
Brooks,3920c9b2662ea352ae32a275bde1e323003357851b8f7bffa23c443a90041fda,617,112,546,12,1287,Brooks3920c9b2662ea352ae32a275bde1e323003357851b8f7bffa23c443a90041fda
Bryan,3920c9b2662ea352ae32a275bde1e323003357851b8f7bffa23c443a90041fda,949,70,1418,1,2438,Bryan3920c9b2662ea352ae32a275bde1e323003357851b8f7bffa23c443a90041fda
Bulloch,3920c9b2662ea352ae32a275bde1e323003357851b8f7bffa23c443a90041fda,2322,158,2313,6,4799,Bulloch3920c9b2662ea352ae32a275bde1e323003357851b8f7bffa23c443a90041fda
Burke,3920c9b2662ea352ae32a275bde1e323003357851b8f7bffa23c443a90041fda,1066,118,732,0,1916,Burke3920c9b2662ea352ae32a275bde1e323003357851b8f7bffa23c443a90041fda
Butts,3920c9b2662ea352ae32a275bde1e323003357851b8f7bffa23c443a90041fda,483,34,1221,0,1738,Butts3920c9b2662ea352ae32a275bde1e323003357851b8f7bffa23c443a90041fda
Calhoun,3920c9b2662ea352ae32a275bde1e323003357851b8f7bffa23c443a90041fda,341,30,160,1,532,Calhoun3920c9b2662ea352ae32a275bde1e323003357851b8f7bffa23c443a90041fda
Camden,3920c9b2662ea352ae32a275bde1e323003357851b8f7bffa23c443a90041fda,1451,161,2006,2,3620,Camden3920c9b2662ea352ae32a275bde1e323003357851b8f7bffa23c443a90041fda
Candler,3920c9b2662ea352ae32a275bde1e323003357851b8f7bffa23c443a90041fda,202,20,526,0,748,Candler3920c9b2662ea352ae32a275bde1e323003357851b8f7bffa23c443a90041fda
Carroll,3920c9b2662ea352ae32a275bde1e323003357851b8f7bffa23c443a90041fda,3748,190,4413,14,8365,Carroll3920c9b2662ea352ae32a275bde1e323003357851b8f7bffa23c443a90041fda
Catoosa,3920c9b2662ea352ae32a275bde1e323003357851b8f7bffa23c443a90041fda,1666,80,2817,0,4563,Catoosa3920c9b2662ea352ae32a275bde1e323003357851b8f7bffa23c443a90041fda
Charlton,3920c9b2662ea352ae32a275bde1e323003357851b8f7bffa23c443a90041fda,434,40,464,2,940,Charlton3920c9b2662ea352ae32a275bde1e323003357851b8f7bffa23c443a90041fda
Chatham,3920c9b2662ea352ae32a275bde1e323003357851b8f7bffa23c443a90041fda,13716,599,6181,20,20516,Chatham3920c9b2662ea352ae32a275bde1e323003357851b8f7bffa23c443a90041fda
Chattahoochee,3920c9b2662ea352ae32a275bde1e323003357851b8f7bffa23c443a90041fda,162,1,115,1,279,Chattahoochee3920c9b2662ea352ae32a275bde1e323003357851b8f7bffa23c443a90041fda
Chattooga,3920c9b2662ea352ae32a275bde1e323003357851b8f7bffa23c443a90041fda,786,33,723,1,1543,Chattooga3920c9b2662ea352ae32a275bde1e323003357851b8f7bffa23c443a90041fda
Cherokee,3920c9b2662ea352ae32a275bde1e323003357851b8f7bffa23c443a90041fda,8111,715,9831,2,18659,Cherokee3920c9b2662ea352ae32a275bde1e323003357851b8f7bffa23c443a90041fda
Clarke,3920c9b2662ea352ae32a275bde1e323003357851b8f7bffa23c443a90041fda,4044,336,4628,18,9026,Clarke3920c9b2662ea352ae32a275bde1e323003357851b8f7bffa23c443a90041fda
Clay,3920c9b2662ea352ae32a275bde1e323003357851b8f7bffa23c443a90041fda,127,14,125,1,267,Clay3920c9b2662ea352ae32a275bde1e323003357851b8f7bffa23c443a90041fda
Clayton,3920c9b2662ea352ae32a275bde1e323003357851b8f7bffa23c443a90041fda,6163,334,8944,39,15480,Clayton3920c9b2662ea352ae32a275bde1e323003357851b8f7bffa23c443a90041fda
Clinch,3920c9b2662ea352ae32a275bde1e323003357851b8f7bffa23c443a90041fda,194,10,237,0,441,Clinch3920c9b2662ea352ae32a275bde1e323003357851b8f7bffa23c443a90041fda
Cobb,3920c9b2662ea352ae32a275bde1e323003357851b8f7bffa23c443a90041fda,31389,3128,22784,149,57450,Cobb3920c9b2662ea352ae32a275bde1e323003357851b8f7bffa23c443a90041fda
Coffee,3920c9b2662ea352ae32a275bde1e323003357851b8f7bffa23c443a90041fda,1097,69,1825,0,2991,Coffee3920c9b2662ea352ae32a275bde1e323003357851b8f7bffa23c443a90041fda
Colquitt,3920c9b2662ea352ae32a275bde1e323003357851b8f7bffa23c443a90041fda,1464,58,1154,0,2676,Colquitt3920c9b2662ea352ae32a275bde1e323003357851b8f7bffa23c443a90041fda
Columbia,3920c9b2662ea352ae32a275bde1e323003357851b8f7bffa23c443a90041fda,4642,355,5723,0,10720,Columbia3920c9b2662ea352ae32a275bde1e323003357851b8f7bffa23c443a90041fda
Cook,3920c9b2662ea352ae32a275bde1e323003357851b8f7bffa23c443a90041fda,574,40,594,0,1208,Cook3920c9b2662ea352ae32a275bde1e323003357851b8f7bffa23c443a90041fda
Coweta,3920c9b2662ea352ae32a275bde1e323003357851b8f7bffa23c443a90041fda,5360,361,5485,3,11209,Coweta3920c9b2662ea352ae32a275bde1e323003357851b8f7bffa23c443a90041fda
Crawford,3920c9b2662ea352ae32a275bde1e323003357851b8f7bffa23c443a90041fda,488,33,606,0,1127,Crawford3920c9b2662ea352ae32a275bde1e323003357851b8f7bffa23c443a90041fda
Crisp,3920c9b2662ea352ae32a275bde1e323003357851b8f7bffa23c443a90041fda,429,50,845,3,1327,Crisp3920c9b2662ea352ae32a275bde1e323003357851b8f7bffa23c443a90041fda
Dade,3920c9b2662ea352ae32a275bde1e323003357851b8f7bffa23c443a90041fda,612,24,539,1,1176,Dade3920c9b2662ea352ae32a275bde1e323003357851b8f7bffa23c443a90041fda
Dawson,3920c9b2662ea352ae32a275bde1e323003357851b8f7bffa23c443a90041fda,528,85,1435,1,2049,Dawson3920c9b2662ea352ae32a275bde1e323003357851b8f7bffa23c443a90041fda
Decatur,3920c9b2662ea352ae32a275bde1e323003357851b8f7bffa23c443a90041fda,1079,90,1395,7,2571,Decatur3920c9b2662ea352ae32a275bde1e323003357851b8f7bffa23c443a90041fda
DeKalb,3920c9b2662ea352ae32a275bde1e323003357851b8f7bffa23c443a90041fda,22266,1755,26736,92,50849,DeKalb3920c9b2662ea352ae32a275bde1e323003357851b8f7bffa23c443a90041fda
Dodge,3920c9b2662ea352ae32a275bde1e323003357851b8f7bffa23c443a90041fda,898,54,642,1,1595,Dodge3920c9b2662ea352ae32a275bde1e323003357851b8f7bffa23c443a90041fda
Dooly,3920c9b2662ea352ae32a275bde1e323003357851b8f7bffa23c443a90041fda,421,19,353,6,799,Dooly3920c9b2662ea352ae32a275bde1e323003357851b8f7bffa23c443a90041fda
Dougherty,3920c9b2662ea352ae32a275bde1e323003357851b8f7bffa23c443a90041fda,3917,202,2511,24,6654,Dougherty3920c9b2662ea352ae32a275bde1e323003357851b8f7bffa23c443a90041fda
Douglas,3920c9b2662ea352ae32a275bde1e323003357851b8f7bffa23c443a90041fda,3664,303,6357,6,10330,Douglas3920c9b2662ea352ae32a275bde1e323003357851b8f7bffa23c443a90041fda
Early,3920c9b2662ea352ae32a275bde1e323003357851b8f7bffa23c443a90041fda,552,58,507,0,1117,Early3920c9b2662ea352ae32a275bde1e323003357851b8f7bffa23c443a90041fda
Echols,3920c9b2662ea352ae32a275bde1e323003357851b8f7bffa23c443a90041fda,90,8,141,0,239,Echols3920c9b2662ea352ae32a275bde1e323003357851b8f7bffa23c443a90041fda
Effingham,3920c9b2662ea352ae32a275bde1e323003357851b8f7bffa23c443a90041fda,1910,89,1829,4,3832,Effingham3920c9b2662ea352ae32a275bde1e323003357851b8f7bffa23c443a90041fda
Elbert,3920c9b2662ea352ae32a275bde1e323003357851b8f7bffa23c443a90041fda,672,68,870,9,1619,Elbert3920c9b2662ea352ae32a275bde1e323003357851b8f7bffa23c443a90041fda
Emanuel,3920c9b2662ea352ae32a275bde1e323003357851b8f7bffa23c443a90041fda,858,57,663,1,1579,Emanuel3920c9b2662ea352ae32a275bde1e323003357851b8f7bffa23c443a90041fda
Evans,3920c9b2662ea352ae32a275bde1e323003357851b8f7bffa23c443a90041fda,244,28,531,0,803,Evans3920c9b2662ea352ae32a275bde1e323003357851b8f7bffa23c443a90041fda
Fannin,3920c9b2662ea352ae32a275bde1e323003357851b8f7bffa23c443a90041fda,1015,132,1031,1,2179,Fannin3920c9b2662ea352ae32a275bde1e323003357851b8f7bffa23c443a90041fda
Fayette,3920c9b2662ea352ae32a275bde1e323003357851b8f7bffa23c443a90041fda,4014,366,7372,4,11756,Fayette3920c9b2662ea352ae32a275bde1e323003357851b8f7bffa23c443a90041fda
Floyd,3920c9b2662ea352ae32a275bde1e323003357851b8f7bffa23c443a90041fda,2851,176,3474,12,6513,Floyd3920c9b2662ea352ae32a275bde1e323003357851b8f7bffa23c443a90041fda
Forsyth,3920c9b2662ea352ae32a275bde1e323003357851b8f7bffa23c443a90041fda,4650,523,11080,6,16259,Forsyth3920c9b2662ea352ae32a275bde1e323003357851b8f7bffa23c443a90041fda
Franklin,3920c9b2662ea352ae32a275bde1e323003357851b8f7bffa23c443a90041fda,770,53,783,0,1606,Franklin3920c9b2662ea352ae32a275bde1e323003357851b8f7bffa23c443a90041fda
Fulton,3920c9b2662ea352ae32a275bde1e323003357851b8f7bffa23c443a90041fda,29449,2578,39968,237,72232,Fulton3920c9b2662ea352ae32a275bde1e323003357851b8f7bffa23c443a90041fda
Gilmer,3920c9b2662ea352ae32a275bde1e323003357851b8f7bffa23c443a90041fda,1212,81,1325,3,2621,Gilmer3920c9b2662ea352ae32a275bde1e323003357851b8f7bffa23c443a90041fda
Glascock,3920c9b2662ea352ae32a275bde1e323003357851b8f7bffa23c443a90041fda,99,12,110,0,221,Glascock3920c9b2662ea352ae32a275bde1e323003357851b8f7bffa23c443a90041fda
Glynn,3920c9b2662ea352ae32a275bde1e323003357851b8f7bffa23c443a90041fda,2911,204,3435,12,6562,Glynn3920c9b2662ea352ae32a275bde1e323003357851b8f7bffa23c443a90041fda
Gordon,3920c9b2662ea352ae32a275bde1e323003357851b8f7bffa23c443a90041fda,1893,86,1709,3,3691,Gordon3920c9b2662ea352ae32a275bde1e323003357851b8f7bffa23c443a90041fda
Grady,3920c9b2662ea352ae32a275bde1e323003357851b8f7bffa23c443a90041fda,937,54,1170,2,2163,Grady3920c9b2662ea352ae32a275bde1e323003357851b8f7bffa23c443a90041fda
Greene,3920c9b2662ea352ae32a275bde1e323003357851b8f7bffa23c443a90041fda,569,99,1005,3,1676,Greene3920c9b2662ea352ae32a275bde1e323003357851b8f7bffa23c443a90041fda
Gwinnett,3920c9b2662ea352ae32a275bde1e323003357851b8f7bffa23c443a90041fda,27961,2226,22647,272,53106,Gwinnett3920c9b2662ea352ae32a275bde1e323003357851b8f7bffa23c443a90041fda
Habersham,3920c9b2662ea352ae32a275bde1e323003357851b8f7bffa23c443a90041fda,572,122,2129,2,2825,Habersham3920c9b2662ea352ae32a275bde1e323003357851b8f7bffa23c443a90041fda
Hall,3920c9b2662ea352ae32a275bde1e323003357851b8f7bffa23c443a90041fda,6344,485,5875,7,12711,Hall3920c9b2662ea352ae32a275bde1e323003357851b8f7bffa23c443a90041fda
Hancock,3920c9b2662ea352ae32a275bde1e323003357851b8f7bffa23c443a90041fda,418,48,309,0,775,Hancock3920c9b2662ea352ae32a275bde1e323003357851b8f7bffa23c443a90041fda
Haralson,3920c9b2662ea352ae32a275bde1e323003357851b8f7bffa23c443a90041fda,1233,59,1078,2,2372,Haralson3920c9b2662ea352ae32a275bde1e323003357851b8f7bffa23c443a90041fda
Harris,3920c9b2662ea352ae32a275bde1e323003357851b8f7bffa23c443a90041fda,1282,69,1376,0,2727,Harris3920c9b2662ea352ae32a275bde1e323003357851b8f7bffa23c443a90041fda
Hart,3920c9b2662ea352ae32a275bde1e323003357851b8f7bffa23c443a90041fda,875,60,1194,0,2129,Hart3920c9b2662ea352ae32a275bde1e323003357851b8f7bffa23c443a90041fda
Heard,3920c9b2662ea352ae32a275bde1e323003357851b8f7bffa23c443a90041fda,466,36,347,0,849,Heard3920c9b2662ea352ae32a275bde1e323003357851b8f7bffa23c443a90041fda
Henry,3920c9b2662ea352ae32a275bde1e323003357851b8f7bffa23c443a90041fda,4906,474,11717,30,17127,Henry3920c9b2662ea352ae32a275bde1e323003357851b8f7bffa23c443a90041fda
Houston,3920c9b2662ea352ae32a275bde1e323003357851b8f7bffa23c443a90041fda,3687,351,7124,20,11182,Houston3920c9b2662ea352ae32a275bde1e323003357851b8f7bffa23c443a90041fda
Irwin,3920c9b2662ea352ae32a275bde1e323003357851b8f7bffa23c443a90041fda,456,14,383,0,853,Irwin3920c9b2662ea352ae32a275bde1e323003357851b8f7bffa23c443a90041fda
Jackson,3920c9b2662ea352ae32a275bde1e323003357851b8f7bffa23c443a90041fda,1869,98,3021,6,4994,Jackson3920c9b2662ea352ae32a275bde1e323003357851b8f7bffa23c443a90041fda
Jasper,3920c9b2662ea352ae32a275bde1e323003357851b8f7bffa23c443a90041fda,442,39,622,1,1104,Jasper3920c9b2662ea352ae32a275bde1e323003357851b8f7bffa23c443a90041fda
Jeff Davis,3920c9b2662ea352ae32a275bde1e323003357851b8f7bffa23c443a90041fda,494,25,446,0,965,Jeff Davis3920c9b2662ea352ae32a275bde1e323003357851b8f7bffa23c443a90041fda
Jefferson,3920c9b2662ea352ae32a275bde1e323003357851b8f7bffa23c443a90041fda,810,73,636,0,1519,Jefferson3920c9b2662ea352ae32a275bde1e323003357851b8f7bffa23c443a90041fda
Jenkins,3920c9b2662ea352ae32a275bde1e323003357851b8f7bffa23c443a90041fda,281,32,330,2,645,Jenkins3920c9b2662ea352ae32a275bde1e323003357851b8f7bffa23c443a90041fda
Johnson,3920c9b2662ea352ae32a275bde1e323003357851b8f7bffa23c443a90041fda,338,32,477,0,847,Johnson3920c9b2662ea352ae32a275bde1e323003357851b8f7bffa23c443a90041fda
Jones,3920c9b2662ea352ae32a275bde1e323003357851b8f7bffa23c443a90041fda,996,64,1445,0,2505,Jones3920c9b2662ea352ae32a275bde1e323003357851b8f7bffa23c443a90041fda
Lamar,3920c9b2662ea352ae32a275bde1e323003357851b8f7bffa23c443a90041fda,642,63,910,4,1619,Lamar3920c9b2662ea352ae32a275bde1e323003357851b8f7bffa23c443a90041fda
Lanier,3920c9b2662ea352ae32a275bde1e323003357851b8f7bffa23c443a90041fda,261,9,313,1,584,Lanier3920c9b2662ea352ae32a275bde1e323003357851b8f7bffa23c443a90041fda
Laurens,3920c9b2662ea352ae32a275bde1e323003357851b8f7bffa23c443a90041fda,2372,191,1960,0,4523,Laurens3920c9b2662ea352ae32a275bde1e323003357851b8f7bffa23c443a90041fda
Lee,3920c9b2662ea352ae32a275bde1e323003357851b8f7bffa23c443a90041fda,1179,60,1167,1,2407,Lee3920c9b2662ea352ae32a275bde1e323003357851b8f7bffa23c443a90041fda
Liberty,3920c9b2662ea352ae32a275bde1e323003357851b8f7bffa23c443a90041fda,1175,85,1635,15,2910,Liberty3920c9b2662ea352ae32a275bde1e323003357851b8f7bffa23c443a90041fda
Lincoln,3920c9b2662ea352ae32a275bde1e323003357851b8f7bffa23c443a90041fda,350,54,443,0,847,Lincoln3920c9b2662ea352ae32a275bde1e323003357851b8f7bffa23c443a90041fda
Long,3920c9b2662ea352ae32a275bde1e323003357851b8f7bffa23c443a90041fda,397,13,319,2,731,Long3920c9b2662ea352ae32a275bde1e323003357851b8f7bffa23c443a90041fda
Lowndes,3920c9b2662ea352ae32a275bde1e323003357851b8f7bffa23c443a90041fda,2542,170,4553,110,7375,Lowndes3920c9b2662ea352ae32a275bde1e323003357851b8f7bffa23c443a90041fda
Lumpkin,3920c9b2662ea352ae32a275bde1e323003357851b8f7bffa23c443a90041fda,545,94,1854,3,2496,Lumpkin3920c9b2662ea352ae32a275bde1e323003357851b8f7bffa23c443a90041fda
Macon,3920c9b2662ea352ae32a275bde1e323003357851b8f7bffa23c443a90041fda,379,34,447,0,860,Macon3920c9b2662ea352ae32a275bde1e323003357851b8f7bffa23c443a90041fda
Madison,3920c9b2662ea352ae32a275bde1e323003357851b8f7bffa23c443a90041fda,1084,87,1326,1,2498,Madison3920c9b2662ea352ae32a275bde1e323003357851b8f7bffa23c443a90041fda
Marion,3920c9b2662ea352ae32a275bde1e323003357851b8f7bffa23c443a90041fda,356,35,290,0,681,Marion3920c9b2662ea352ae32a275bde1e323003357851b8f7bffa23c443a90041fda
McDuffie,3920c9b2662ea352ae32a275bde1e323003357851b8f7bffa23c443a90041fda,677,99,1029,0,1805,McDuffie3920c9b2662ea352ae32a275bde1e323003357851b8f7bffa23c443a90041fda
McIntosh,3920c9b2662ea352ae32a275bde1e323003357851b8f7bffa23c443a90041fda,570,115,729,1,1415,McIntosh3920c9b2662ea352ae32a275bde1e323003357851b8f7bffa23c443a90041fda
Meriwether,3920c9b2662ea352ae32a275bde1e323003357851b8f7bffa23c443a90041fda,1201,56,707,3,1967,Meriwether3920c9b2662ea352ae32a275bde1e323003357851b8f7bffa23c443a90041fda
Miller,3920c9b2662ea352ae32a275bde1e323003357851b8f7bffa23c443a90041fda,262,27,257,2,548,Miller3920c9b2662ea352ae32a275bde1e323003357851b8f7bffa23c443a90041fda
Mitchell,3920c9b2662ea352ae32a275bde1e323003357851b8f7bffa23c443a90041fda,830,155,752,0,1737,Mitchell3920c9b2662ea352ae32a275bde1e323003357851b8f7bffa23c443a90041fda
Monroe,3920c9b2662ea352ae32a275bde1e323003357851b8f7bffa23c443a90041fda,1165,76,1226,3,2470,Monroe3920c9b2662ea352ae32a275bde1e323003357851b8f7bffa23c443a90041fda
Montgomery,3920c9b2662ea352ae32a275bde1e323003357851b8f7bffa23c443a90041fda,478,23,292,0,793,Montgomery3920c9b2662ea352ae32a275bde1e323003357851b8f7bffa23c443a90041fda
Morgan,3920c9b2662ea352ae32a275bde1e323003357851b8f7bffa23c443a90041fda,751,68,1189,1,2009,Morgan3920c9b2662ea352ae32a275bde1e323003357851b8f7bffa23c443a90041fda
Murray,3920c9b2662ea352ae32a275bde1e323003357851b8f7bffa23c443a90041fda,1222,42,1072,0,2336,Murray3920c9b2662ea352ae32a275bde1e323003357851b8f7bffa23c443a90041fda
Muscogee,3920c9b2662ea352ae32a275bde1e323003357851b8f7bffa23c443a90041fda,6618,488,6636,26,13768,Muscogee3920c9b2662ea352ae32a275bde1e323003357851b8f7bffa23c443a90041fda
Newton,3920c9b2662ea352ae32a275bde1e323003357851b8f7bffa23c443a90041fda,3734,249,3441,0,7424,Newton3920c9b2662ea352ae32a275bde1e323003357851b8f7bffa23c443a90041fda
Oconee,3920c9b2662ea352ae32a275bde1e323003357851b8f7bffa23c443a90041fda,1544,129,2188,0,3861,Oconee3920c9b2662ea352ae32a275bde1e323003357851b8f7bffa23c443a90041fda
Oglethorpe,3920c9b2662ea352ae32a275bde1e323003357851b8f7bffa23c443a90041fda,480,56,793,0,1329,Oglethorpe3920c9b2662ea352ae32a275bde1e323003357851b8f7bffa23c443a90041fda
Paulding,3920c9b2662ea352ae32a275bde1e323003357851b8f7bffa23c443a90041fda,3411,406,7069,4,10890,Paulding3920c9b2662ea352ae32a275bde1e323003357851b8f7bffa23c443a90041fda
Peach,3920c9b2662ea352ae32a275bde1e323003357851b8f7bffa23c443a90041fda,706,57,1427,1,2191,Peach3920c9b2662ea352ae32a275bde1e323003357851b8f7bffa23c443a90041fda
Pickens,3920c9b2662ea352ae32a275bde1e323003357851b8f7bffa23c443a90041fda,1099,35,1750,1,2885,Pickens3920c9b2662ea352ae32a275bde1e323003357851b8f7bffa23c443a90041fda
Pierce,3920c9b2662ea352ae32a275bde1e323003357851b8f7bffa23c443a90041fda,504,36,1222,0,1762,Pierce3920c9b2662ea352ae32a275bde1e323003357851b8f7bffa23c443a90041fda
Pike,3920c9b2662ea352ae32a275bde1e323003357851b8f7bffa23c443a90041fda,700,50,1143,1,1894,Pike3920c9b2662ea352ae32a275bde1e323003357851b8f7bffa23c443a90041fda
Polk,3920c9b2662ea352ae32a275bde1e323003357851b8f7bffa23c443a90041fda,893,61,1767,3,2724,Polk3920c9b2662ea352ae32a275bde1e323003357851b8f7bffa23c443a90041fda
Pulaski,3920c9b2662ea352ae32a275bde1e323003357851b8f7bffa23c443a90041fda,191,30,527,0,748,Pulaski3920c9b2662ea352ae32a275bde1e323003357851b8f7bffa23c443a90041fda
Putnam,3920c9b2662ea352ae32a275bde1e323003357851b8f7bffa23c443a90041fda,735,124,1112,0,1971,Putnam3920c9b2662ea352ae32a275bde1e323003357851b8f7bffa23c443a90041fda
Quitman,3920c9b2662ea352ae32a275bde1e323003357851b8f7bffa23c443a90041fda,109,6,93,0,208,Quitman3920c9b2662ea352ae32a275bde1e323003357851b8f7bffa23c443a90041fda
Rabun,3920c9b2662ea352ae32a275bde1e323003357851b8f7bffa23c443a90041fda,255,113,1087,0,1455,Rabun3920c9b2662ea352ae32a275bde1e323003357851b8f7bffa23c443a90041fda
Randolph,3920c9b2662ea352ae32a275bde1e323003357851b8f7bffa23c443a90041fda,304,27,239,1,571,Randolph3920c9b2662ea352ae32a275bde1e323003357851b8f7bffa23c443a90041fda
Richmond,3920c9b2662ea352ae32a275bde1e323003357851b8f7bffa23c443a90041fda,7097,523,6508,24,14152,Richmond3920c9b2662ea352ae32a275bde1e323003357851b8f7bffa23c443a90041fda
Rockdale,3920c9b2662ea352ae32a275bde1e323003357851b8f7bffa23c443a90041fda,2036,155,4505,6,6702,Rockdale3920c9b2662ea352ae32a275bde1e323003357851b8f7bffa23c443a90041fda
Schley,3920c9b2662ea352ae32a275bde1e323003357851b8f7bffa23c443a90041fda,126,16,262,0,404,Schley3920c9b2662ea352ae32a275bde1e323003357851b8f7bffa23c443a90041fda
Screven,3920c9b2662ea352ae32a275bde1e323003357851b8f7bffa23c443a90041fda,638,25,677,0,1340,Screven3920c9b2662ea352ae32a275bde1e323003357851b8f7bffa23c443a90041fda
Seminole,3920c9b2662ea352ae32a275bde1e323003357851b8f7bffa23c443a90041fda,449,23,257,1,730,Seminole3920c9b2662ea352ae32a275bde1e323003357851b8f7bffa23c443a90041fda
Spalding,3920c9b2662ea352ae32a275bde1e323003357851b8f7bffa23c443a90041fda,2035,130,3043,2,5210,Spalding3920c9b2662ea352ae32a275bde1e323003357851b8f7bffa23c443a90041fda
Stephens,3920c9b2662ea352ae32a275bde1e323003357851b8f7bffa23c443a90041fda,366,89,1403,1,1859,Stephens3920c9b2662ea352ae32a275bde1e323003357851b8f7bffa23c443a90041fda
Stewart,3920c9b2662ea352ae32a275bde1e323003357851b8f7bffa23c443a90041fda,210,45,131,1,387,Stewart3920c9b2662ea352ae32a275bde1e323003357851b8f7bffa23c443a90041fda
Sumter,3920c9b2662ea352ae32a275bde1e323003357851b8f7bffa23c443a90041fda,1024,86,1188,0,2298,Sumter3920c9b2662ea352ae32a275bde1e323003357851b8f7bffa23c443a90041fda
Talbot,3920c9b2662ea352ae32a275bde1e323003357851b8f7bffa23c443a90041fda,384,82,165,0,631,Talbot3920c9b2662ea352ae32a275bde1e323003357851b8f7bffa23c443a90041fda
Taliaferro,3920c9b2662ea352ae32a275bde1e323003357851b8f7bffa23c443a90041fda,80,9,82,0,171,Taliaferro3920c9b2662ea352ae32a275bde1e323003357851b8f7bffa23c443a90041fda
Tattnall,3920c9b2662ea352ae32a275bde1e323003357851b8f7bffa23c443a90041fda,647,89,830,1,1567,Tattnall3920c9b2662ea352ae32a275bde1e323003357851b8f7bffa23c443a90041fda
Taylor,3920c9b2662ea352ae32a275bde1e323003357851b8f7bffa23c443a90041fda,310,29,339,0,678,Taylor3920c9b2662ea352ae32a275bde1e323003357851b8f7bffa23c443a90041fda
Telfair,3920c9b2662ea352ae32a275bde1e323003357851b8f7bffa23c443a90041fda,471,69,347,0,887,Telfair3920c9b2662ea352ae32a275bde1e323003357851b8f7bffa23c443a90041fda
Terrell,3920c9b2662ea352ae32a275bde1e323003357851b8f7bffa23c443a90041fda,420,32,372,0,824,Terrell3920c9b2662ea352ae32a275bde1e323003357851b8f7bffa23c443a90041fda
Thomas,3920c9b2662ea352ae32a275bde1e323003357851b8f7bffa23c443a90041fda,1617,137,2068,1,3823,Thomas3920c9b2662ea352ae32a275bde1e323003357851b8f7bffa23c443a90041fda
Tift,3920c9b2662ea352ae32a275bde1e323003357851b8f7bffa23c443a90041fda,1141,84,1462,2,2689,Tift3920c9b2662ea352ae32a275bde1e323003357851b8f7bffa23c443a90041fda
Toombs,3920c9b2662ea352ae32a275bde1e323003357851b8f7bffa23c443a90041fda,807,89,1049,1,1946,Toombs3920c9b2662ea352ae32a275bde1e323003357851b8f7bffa23c443a90041fda
Towns,3920c9b2662ea352ae32a275bde1e323003357851b8f7bffa23c443a90041fda,352,41,748,1,1142,Towns3920c9b2662ea352ae32a275bde1e323003357851b8f7bffa23c443a90041fda
Treutlen,3920c9b2662ea352ae32a275bde1e323003357851b8f7bffa23c443a90041fda,232,27,356,1,616,Treutlen3920c9b2662ea352ae32a275bde1e323003357851b8f7bffa23c443a90041fda
Troup,3920c9b2662ea352ae32a275bde1e323003357851b8f7bffa23c443a90041fda,2646,176,2570,48,5440,Troup3920c9b2662ea352ae32a275bde1e323003357851b8f7bffa23c443a90041fda
Turner,3920c9b2662ea352ae32a275bde1e323003357851b8f7bffa23c443a90041fda,293,9,463,1,766,Turner3920c9b2662ea352ae32a275bde1e323003357851b8f7bffa23c443a90041fda
Twiggs,3920c9b2662ea352ae32a275bde1e323003357851b8f7bffa23c443a90041fda,466,48,350,1,865,Twiggs3920c9b2662ea352ae32a275bde1e323003357851b8f7bffa23c443a90041fda
Union,3920c9b2662ea352ae32a275bde1e323003357851b8f7bffa23c443a90041fda,848,87,1382,2,2319,Union3920c9b2662ea352ae32a275bde1e323003357851b8f7bffa23c443a90041fda
Upson,3920c9b2662ea352ae32a275bde1e323003357851b8f7bffa23c443a90041fda,677,65,1575,2,2319,Upson3920c9b2662ea352ae32a275bde1e323003357851b8f7bffa23c443a90041fda
Walker,3920c9b2662ea352ae32a275bde1e323003357851b8f7bffa23c443a90041fda,1888,141,2655,2,4686,Walker3920c9b2662ea352ae32a275bde1e323003357851b8f7bffa23c443a90041fda
Walton,3920c9b2662ea352ae32a275bde1e323003357851b8f7bffa23c443a90041fda,3849,192,2851,7,6899,Walton3920c9b2662ea352ae32a275bde1e323003357851b8f7bffa23c443a90041fda
Ware,3920c9b2662ea352ae32a275bde1e323003357851b8f7bffa23c443a90041fda,1132,94,1295,6,2527,Ware3920c9b2662ea352ae32a275bde1e323003357851b8f7bffa23c443a90041fda
Warren,3920c9b2662ea352ae32a275bde1e323003357851b8f7bffa23c443a90041fda,263,15,301,0,579,Warren3920c9b2662ea352ae32a275bde1e323003357851b8f7bffa23c443a90041fda
Washington,3920c9b2662ea352ae32a275bde1e323003357851b8f7bffa23c443a90041fda,876,113,868,8,1865,Washington3920c9b2662ea352ae32a275bde1e323003357851b8f7bffa23c443a90041fda
Wayne,3920c9b2662ea352ae32a275bde1e323003357851b8f7bffa23c443a90041fda,973,72,1256,3,2304,Wayne3920c9b2662ea352ae32a275bde1e323003357851b8f7bffa23c443a90041fda
Webster,3920c9b2662ea352ae32a275bde1e323003357851b8f7bffa23c443a90041fda,95,13,102,0,210,Webster3920c9b2662ea352ae32a275bde1e323003357851b8f7bffa23c443a90041fda
Wheeler,3920c9b2662ea352ae32a275bde1e323003357851b8f7bffa23c443a90041fda,215,32,209,0,456,Wheeler3920c9b2662ea352ae32a275bde1e323003357851b8f7bffa23c443a90041fda
White,3920c9b2662ea352ae32a275bde1e323003357851b8f7bffa23c443a90041fda,934,61,1052,1,2048,White3920c9b2662ea352ae32a275bde1e323003357851b8f7bffa23c443a90041fda
Whitfield,3920c9b2662ea352ae32a275bde1e323003357851b8f7bffa23c443a90041fda,3477,182,2550,6,6215,Whitfield3920c9b2662ea352ae32a275bde1e323003357851b8f7bffa23c443a90041fda
Wilcox,3920c9b2662ea352ae32a275bde1e323003357851b8f7bffa23c443a90041fda,354,42,251,0,647,Wilcox3920c9b2662ea352ae32a275bde1e323003357851b8f7bffa23c443a90041fda
Wilkes,3920c9b2662ea352ae32a275bde1e323003357851b8f7bffa23c443a90041fda,528,29,485,1,1043,Wilkes3920c9b2662ea352ae32a275bde1e323003357851b8f7bffa23c443a90041fda
Wilkinson,3920c9b2662ea352ae32a275bde1e323003357851b8f7bffa23c443a90041fda,572,33,284,0,889,Wilkinson3920c9b2662ea352ae32a275bde1e323003357851b8f7bffa23c443a90041fda
Worth,3920c9b2662ea352ae32a275bde1e323003357851b8f7bffa23c443a90041fda,1016,63,627,0,1706,Worth3920c9b2662ea352ae32a275bde1e323003357851b8f7bffa23c443a90041fda
